toward	[tɔːrdz]	к, по направлению к
successful	[səkˈsesfl]	успешный, преуспевающий
beam	[biːm]	луч, излучать
gold	[ɡoʊld]	золото, золотой
thing	[θɪŋ]	вещь, предмет
existence	[ɪɡˈzɪstəns]	существование, бытие
screen	[skriːn]	экран
sister	[ˈsɪstər]	сестра
mother	[ˈmʌðər]	мать
deal	[diːl]	дело, сделка, иметь дело
likely	[ˈlaɪkli]	вероятно, вероятный
population	[ˌpɑːpjuˈleɪʃn]	население, жители
country	[ˈkʌntri]	страна, провинция, сельский
date	[deɪt]	дата, день, датировать(ся)
restaurant	[ˈrest(ə)rɑːnt]	ресторан
figure	[ˈfɪɡjər]	фигура, внешний вид, изображать
beginning	[bɪˈɡɪnɪŋ]	начало
basketball	[ˈbæskɪtbɔːl]	баскетбол
dangerous	[ˈdeɪndʒərəs]	опасный
seriously	[ˈsɪriəsli]	серьезно, всерьез
effective	[ɪˈfektɪv]	эффективный
not	[nɑt]	не, нет
provide	[prəˈvaɪd]	снабжать, предоставлять
encourage	[ɪnˈkɜːrɪdʒ]	поощрять
translate	[trænsˈleɪt]	переводить
thirteen	[ˌθɜːrˈtiːn]	тринадцать
interrupt	[ˌɪntəˈrʌpt]	прерывать, перебивать
compete	[kəmˈpiːt]	соревноваться, конкурировать
say	[seɪ]	говорить, сказать
nor	[nɔːr]	ни
seek	[siːk]	искать, разыскивать
cover	[ˈkʌvər]	покрывать, накрывать, крышка
complain	[kəmˈpleɪn]	(по)жаловаться
modern	[ˈmɑːdərn]	современный
calm	[kɑːm]	спокойный, тихий, спокойствие
engineer	[ˌendʒɪˈnɪr]	инженер, механик, проектировать
play	[pleɪ]	играть, игра
announce	[əˈnaʊns]	объявлять, анонсировать
notice	[ˈnoʊtɪs]	замечать, внимание
movement	[ˈmuːvmənt]	движение
depth	[depθ]	глубина
record	[ˈrekərd]	запись, регистрация, записывать
wound	[wuːnd]	рана, ранить
pain	[peɪn]	боль, причинять боль
accept	[əkˈsept]	принимать, признавать
dinner	[ˈdɪnər]	обед
sing	[sɪŋ]	петь
heaven	[ˈhevn]	небеса, небо
murder	[ˈmɜːrdər]	убийство, убивать
victim	[ˈvɪktɪm]	жертва
although	[ɔːlˈðoʊ]	хотя, несмотря на то, что
atom	[ˈætəm]	атом, мельчайшая частица
threaten	[ˈθretn]	угрожать
boring	[ˈbɔːrɪŋ]	скучный
crazy	[ˈkreɪzi]	сумасшедший, безумный, сумасшедший
vehicle	[ˈviːəkl]	автомобиль, транспортное средство
evening	[ˈiːvnɪŋ]	вечер
bury	[ˈberi]	хоронить, закапывать
total	[ˈtoʊtl]	весь, полный, сумма
exist	[ɪɡˈzɪst]	существовать, быть
excuse	[n - ɪkˈskjuːs, v - ɪkˈskjuːz]	извинять(ся), извинение
brother	[ˈbrʌðər]	брат
seem	[siːm]	казаться, представляться
soft	[sɔːft]	мягкий
industry	[ˈɪndəstri]	индустрия, промышленность
option	[ˈɑːpʃn]	вариант, выбор
quiet	[ˈkwaɪət]	тихий, тишина
final	[ˈfaɪnl]	финальный, последний
silly	[ˈsɪli]	глупый
institution	[ˌɪnstɪˈtuːʃn]	учреждение, организация
bed	[bed]	кровать, укладывать спать
repeat	[rɪˈpiːt]	повторять
swallow	[ˈswɑːloʊ]	глотать, глоток
every	[ˈevri]	каждый, любой
politics	[ˈpɑːlətɪks]	политика
union	[ˈjuːniən]	союз, объединение
noun	[naʊn]	существительное
blue	[bluː]	синий, голубой, синий цвет
recently	[ˈriːsntli]	недавно
tendency	[ˈtendənsi]	тенденция, склонность
rush	[rʌʃ]	торопить(ся), мчаться, спешка
row	[roʊ]	ряд, строка, грести
favorite	[ˈfeɪvərɪt]	любимый, фаворит
artificial	[ˌɑːrtɪˈfɪʃl]	искусственный
expect	[ɪkˈspekt]	ждать, ожидать
outdoor	[ˈaʊtdɔːr]	наружный, внешний
knot	[nɑːt]	узел, завязывать узел
law	[lɔː]	закон, право
engine	[ˈendʒɪn]	двигатель, машина
soldier	[ˈsoʊldʒər]	солдат
there	[ðer]	там, туда
similar	[ˈsɪmələr]	похожий, сходный
curl	[kɜːrl]	локон, завиток, виться
juice	[dʒuːs]	сок
on	[ɔːn, ɑːn]	на
threat	[θret]	угроза
best	[best]	самое лучшее, лучший
contain	[kənˈteɪn]	содержать, сдерживать
doubt	[daʊt]	сомнение, сомневаться
belief	[bɪˈliːf]	вера, убеждение
within	[wɪˈðɪn]	внутри, в рамках
severe	[sɪˈvɪr]	суровый, серьезный
key	[kiː]	ключ, клавиша, ключевой
entrance	[ˈentrəns]	вход
interesting	[ˈɪntrəstɪŋ]	интересный
scale	[skeɪl]	шкала, масштаб
bag	[bæɡ]	сумка, мешок
poem	[ˈpoʊəm]	стихотворение
board	[bɔːrd]	доска
space	[speɪs]	пространство, космос, оставлять промежутки
rapid	[ˈræpɪd]	быстрый, скорый
wait	[weɪt]	ждать, ожидание
thanks	[θæŋks]	спасибо, благодарность
cheat	[tʃiːt]	жульничать, обманывать, мошенничество
female	[ˈfiːmeɪl]	женщина, женский
body	[ˈbɑːdi]	тело, туловище
object	[ˈɑːbdʒɪkt]	объект, предмет, возражать
war	[wɔːr]	война
nothing	[ˈnʌθɪŋ]	ничто, ничто
base	[beɪs]	основа, базис, базировать
tent	[tent]	палатка
mile	[maɪl]	миля, 1609 метров
sun	[sʌn]	солнце
tear	[n - tɪr, v - ter]	рвать(ся), разрывать(ся), слеза
technical	[ˈteknɪkl]	технический
traffic	[ˈtræfɪk]	трафик, движение
stamp	[stæmp]	штамп, печать, штамповать
sand	[sænd]	песок
tea	[tiː]	чай
bank	[bæŋk]	банк, берег (реки), банковский
prince	[prɪns]	принц, князь
pretty	[ˈprɪti]	симпатичный, хорошенький, довольно
someone	[ˈsʌmwʌn]	кто-то, кто-нибудь
sail	[seɪl]	плавать (под парусом), совершать плавание, парус
nineteen	[ˌnaɪnˈtiːn]	девятнадцать
Wednesday	[ˈwenzd(e)ɪ]	среда
have	[həv, hæv]	иметь, обладать
nowhere	[ˈnoʊwer]	нигде, никуда
invitation	[ˌɪnvɪˈteɪʃn]	приглашение
employee	[ɪmˈplɔɪiː]	сотрудник, работник
liquid	[ˈlɪkwɪd]	жидкость, жидкий
rule	[ruːl]	правило, править
since	[sɪns]	с, с тех пор
practice	[ˈpræktɪs]	практика, практиковаться
authority	[əˈθɔːrəti]	власть, органы власти
season	[ˈsiːzn]	сезон, время года
sympathy	[ˈsɪmpəθi]	симпатия, сочувствие
angle	[ˈæŋɡl]	угол
familiar	[fəˈmɪliər]	знакомый, привычный
this	[ðɪs]	этот, это
cheap	[tʃiːp]	дешевый, недорогой, дешево
prevent	[prɪˈvent]	предотвращать
tense	[tens]	напряженный, натянутый, грамматическое время
affect	[əˈfekt]	влиять, затрагивать
imagine	[ɪˈmædʒɪn]	воображать, представлять
sensible	[ˈsensəbl]	разумный, здравомыслящий
fun	[fʌn]	веселье, веселый
seven	[ˈsevn]	семь, семерка
absolutely	[ˈæbsəluːtli]	абсолютно, совершенно
light	[laɪt]	светить, освещать, свет
silver	[ˈsɪlvər]	серебро, серебряный
suggest	[sə(ɡ)ˈdʒest]	предлагать, советовать
let	[let]	позволять, разрешать
fear	[fɪr]	страх, боязнь, страшиться
able	[ˈeɪbl]	способный, обладающий способностью
fire	[ˈfaɪər]	огонь, пожар, стрелять
shut	[ʃʌt]	закрывать(ся), запирать(ся)
floor	[flɔːr]	пол, этаж
lot	[lɑːt]	много, уйма, намного
waist	[weɪst]	талия
neat	[niːt]	опрятный, чистый
peaceful	[ˈpiːsfl]	мирный, спокойный
bowl	[boʊl]	кубок, чаша
fit	[fɪt]	подходить, соответствовать, в хорошей форме
side	[saɪd]	сторона, боковой
pour	[pɔːr]	лить(ся), наливать
important	[ɪmˈpɔːrtnt]	важный, значительный
royal	[ˈrɔɪəl]	королевский, царский
shelter	[ˈʃeltər]	приют, укрытие, приютить
deliver	[dɪˈlɪvər]	доставлять
book	[bʊk]	книга, бронировать
foot	[fʊt]	ступня
motor	[ˈmoʊtər]	мотор, двигатель
significant	[sɪɡˈnɪfɪkənt]	значительный, существенный
door	[dɔːr]	дверь
shake	[ʃeɪk]	трясти, встряска
influence	[ˈɪnfluəns]	влияние, влиять
after	[ˈæftər]	после, за, после того как
attempt	[əˈtempt]	попытка, покушение, пытаться
when	[wen]	когда, когда
mass	[mæs]	масса, массовый
add	[æd]	прибавлять, присоединять
village	[ˈvɪlɪdʒ]	деревня
shot	[ʃɑːt]	выстрел, кадр
famous	[ˈfeɪməs]	известный, знаменитый
theater	[ˈθiːətər]	театр
eighteen	[ˌeɪˈtiːn]	восемнадцать
drive	[draɪv]	ехать, вести, езда
crush	[krʌʃ]	(раз)давить, дробить
connect	[kəˈnekt]	соединять, подключать
room	[ruːm]	комната, пространство
realize	[ˈriəlaɪz]	реализовать, понимать
October	[ɑːkˈtoʊbər]	октябрь
upon	[əˈpɔːn, əˈpɑːn]	на
white	[waɪt]	белый, белый цвет
paint	[peɪnt]	краска, рисовать (красками)
agreement	[əˈɡriːmənt]	соглашение, договор
six	[sɪks]	шесть
succeed	[succeed]	преуспевать, иметь успех
debt	[det]	долг, задолженность
ahead	[əˈhed]	впереди, вперед, будущий
bake	[beɪk]	печь(ся), выпекать(ся)
visit	[ˈvɪzɪt]	посещать, навещать, посещение
appearance	[əˈpɪrəns]	внешний вид, появление
surround	[səˈraʊnd]	окружать
soup	[suːp]	суп
curve	[kɜːrv]	кривая, изгиб, изгибать(ся)
fur	[fɜːr]	мех
drunk	[drʌŋk]	пьяный
grandfather	[ˈɡrænfɑːðər]	дедушка
bye	[baɪ]	пока, до свидания
map	[mæp]	карта
desk	[desk]	письменный стол, парта
ring	[rɪŋ]	кольцо, звон, звонить
movie	[ˈmuːvi]	кино
pick	[pɪk]	собирать, выбирать, выбор
peace	[piːs]	мир, покой
progress	[n - ˈprɑːɡres, v - prəˈɡres]	прогресс, движение вперед, развиваться
while	[waɪl]	пока, в то время как, промежуток времени
write	[raɪt]	писать
task	[tæsk]	задача, задание
bullet	[ˈbʊlɪt]	пуля
intend	[ɪnˈtend]	намереваться
purpose	[ˈpɜːrpəs]	цель, назначение
small	[smɔːl]	маленький, небольшой
manage	[ˈmænɪdʒ]	управлять, справляться
strike	[straɪk]	ударять, бить, удар
unit	[ˈjuːnɪt]	часть, единица
concerning	[kənˈsɜːrnɪŋ]	относительно, касательно
green	[ɡriːn]	зеленый, зеленый цвет
author	[ˈɔːθər]	автор
bridge	[brɪdʒ]	мост
inner	[ˈɪnər]	внутренний
shout	[ʃaʊt]	кричать, крик
anything	[ˈeniθɪŋ]	что-нибудь, что угодно
worth	[wɜːrθ]	стоящий, стоимость
statement	[ˈsteɪtmənt]	заявление, утверждение
suitcase	[ˈsuːtkeɪs]	чемодан
person	[ˈpɜːrsn]	человек, личность
level	[ˈlevl]	уровень, степень, плоский
less	[les]	меньше, менее, меньший
alphabet	[ˈælfəbet]	алфавит
ceremony	[ˈserəmoʊni]	церемония
stair	[ster]	ступенька
will	[wɪl]	воля, желание
create	[kriˈeɪt]	создавать, порождать
president	[ˈprezɪdənt]	президент, председатель
poetry	[ˈpoʊətri]	поэзия, стихи
fix	[fɪks]	исправлять, фиксировать
allow	[əˈlaʊ]	позволять, разрешать
pretend	[prɪˈtend]	притворяться
awkward	[ˈɔːkwərd]	неловкий, неуклюжий
straight	[streɪt]	прямой, прямо
insect	[ˈɪnsekt]	насекомое
party	[ˈpɑːrti]	партия, группа
description	[dɪˈskrɪpʃn]	описание
muscle	[ˈmʌsl]	мышца, мускул
exchange	[ɪksˈtʃeɪndʒ]	обмен, обменивать
satisfy	[ˈsætɪsfaɪ]	удовлетворять
safe	[seɪf]	безопасный, надежный, сейф
weight	[weɪt]	вес
shy	[ʃaɪ]	стеснительный, застенчивый
near	[nɪr]	возле, около, недалеко
tiring	[ˈtaɪərɪŋ]	утомительный, изнурительный
attach	[əˈtætʃ]	прикреплять(ся), присоединять(ся)
conscious	[ˈkɑːnʃəs]	сознательный, сознающий
up	[ʌp]	вверх
upstairs	[ˌʌpˈsterz]	наверху, вверх по лестнице
probably	[ˈprɑːbəbli]	вероятно, наверное
protect	[prəˈtekt]	защищать, охранять
lady	[ˈleɪdi]	леди, дама
employ	[ɪmˈplɔɪ]	нанимать, применять
screw	[skruː]	винт, болт, завинчивать
strong	[strɔːŋ]	сильный
farm	[fɑːrm]	ферма
expensive	[ɪkˈspensɪv]	дорогой
note	[noʊt]	заметка, записка, замечать
meat	[miːt]	мясо
combination	[ˌkɑːmbɪˈneɪʃn]	комбинация, сочетание
tire	[ˈtaɪər]	шина, утомлять(ся)
popular	[ˈpɑːpjələr]	популярный
song	[sɔːŋ]	песня, пение
short	[ʃɔːrt]	короткий, коротко
material	[məˈtɪriəl]	материал, вещество, материальный
support	[səˈpɔːrt]	поддержка, поддерживать
patience	[ˈpeɪʃns]	терпение
replace	[rɪˈpleɪs]	заменять, замещать
southern	[ˈsʌðərn]	южный
do	[du, duː]	делать
military	[ˈmɪləteri]	военный, воинский, военные
enough	[ɪˈnʌf]	достаточный, достаточно
hat	[hæt]	шапка, шляпа
difficulty	[ˈdɪfɪkəlti]	трудность
positive	[ˈpɑːzətɪv]	позитивный, положительный
proof	[pruːf]	доказательство, непроницаемый
alone	[əˈloʊn]	одинокий, единственный, в одиночестве
undo	[ʌnˈduː]	расстегивать, развязывать
public	[ˈpʌblɪk]	общественный, народный, публика
refusal	[rɪˈfjuːzl]	отказ
officer	[ˈɔːfɪsər]	офицер, полицейский
then	[ðen]	тогда, затем
knee	[niː]	колено
spoil	[spɔɪl]	портить(ся), баловать
married	[ˈmærid]	женатый, замужняя
pan	[pæn]	кастрюля, сковорода
tobacco	[təˈbækoʊ]	табак
point	[pɔɪnt]	точка, момент, указывать
drop	[drɑːp]	ронять, капать, падение
communicate	[kəˈmjuːnɪkeɪt]	сообщать, общаться
width	[wɪdθ, wɪtθ]	ширина
castle	[ˈkæsl]	замок, дворец
gun	[ɡʌn]	пистолет, пушка
express	[ɪkˈspres]	выражать, высказывать, экспресс (поезд)
electronic	[ɪˌlekˈtrɑːnɪk]	электронный
gray	[ɡreɪ]	серый, седой, серый цвет
kilometer	[kɪˈlɑːmɪtər]	километр
produce	[prəˈduːs]	производить, выпускать, изделие
habit	[ˈhæbɪt]	привычка, обычай
zero	[ˈzɪroʊ]	ноль
frame	[freɪm]	рамка, рама
plastic	[ˈplæstɪk]	пластик, пластмасса, пластиковый
business	[ˈbɪznəs]	дело, бизнес
quarter	[ˈkwɔːrtər]	четверть, квартал
actual	[ˈæktʃuəl]	фактический, настоящий
beauty	[ˈbjuːti]	красота
change	[tʃeɪndʒ]	менять, меняться, перемена
melt	[melt]	плавить(ся), таять
drink	[drɪŋk]	пить, напиток
river	[ˈrɪvər]	река
count	[kaʊnt]	считать, подсчитывать, вычисление
air	[er]	воздух, атмосфера, проветривать
toy	[tɔɪ]	игрушка
fact	[fækt]	факт, явление
pause	[pɔːz]	пауза, делать паузу
goal	[ɡoʊl]	цель, задача
husband	[ˈhʌzbənd]	муж, супруг
science	[ˈsaɪəns]	наука
wrist	[rɪst]	запястье
past	[pæst]	прошлое, прошлый
throat	[θroʊt]	горло
embarrass	[ɪmˈbærəs]	смущать, стеснять
TV	[ˌtiː ˈviː]	телевидение, телевизор
daily	[ˈdeɪli]	ежедневный, ежедневно
weigh	[weɪ]	весить, взвешивать(ся)
laugh	[læf]	смеяться, смех
spot	[spɑːt]	пятно, место
cook	[kʊk]	готовить, повар
profit	[ˈprɑːfɪt]	прибыль, выгода
trust	[trʌst]	вера, доверие, верить
argument	[ˈɑːrɡjumənt]	аргумент, довод
fold	[foʊld]	складывать, складка
hospital	[ˈhɑːspɪtl]	больница, госпиталь
baby	[ˈbeɪbi]	ребенок, младенец, детский
experience	[ɪkˈspɪriəns]	опыт, опытность, испытывать
pleasant	[ˈpleznt]	приятный
punish	[ˈpʌnɪʃ]	наказывать
danger	[ˈdeɪndʒər]	опасность
clothes	[kloʊ(ð)z]	одежда
bell	[bel]	колокол, звонок
action	[ˈækʃn]	действие, поступок
police	[pəˈliːs]	полиция, полицейские
still	[stɪl]	по-прежнему, ещё
speak	[spiːk]	говорить
search	[sɜːrtʃ]	поиск, искать
lift	[lɪft]	поднимать(ся), подъем
boot	[buːt]	ботинок, сапог
leader	[ˈliːdər]	лидер, руководитель
whole	[hoʊl]	целый, весь, целое
result	[rɪˈzʌlt]	результат, следовать
insurance	[ɪnˈʃʊrəns]	страхование, страховка
behave	[bɪˈheɪv]	вести себя
fashionable	[ˈfæʃnəbl]	модный
bread	[bred]	хлеб
seat	[siːt]	сиденье
general	[ˈdʒenrəl]	общий, обычный, генерал
comfort	[ˈkʌmfərt]	комфорт, удобства, подбадривать
insult	[n - ˈɪnsʌlt, v - ɪnˈsʌlt]	оскорбление, оскорблять
emphasize	[ˈemfəsaɪz]	подчеркивать, акцентировать
storm	[stɔːrm]	буря, гроза
certain	[ˈsɜːrtn]	определенный, точный
tail	[teɪl]	хвост
terrible	[ˈterəbl]	ужасный
hole	[hoʊl]	дыра, отверстие
steal	[stiːl]	воровать, красть
eastern	[ˈiːstərn]	восточный
will	[wɪl]	образует будущее время
describe	[dɪˈskraɪb]	описывать
far	[fɑːr]	далекий, далеко
promise	[ˈprɑːmɪs]	обещание, обещать
rise	[raɪz]	подниматься, восходить, рост
soul	[soʊl]	душа
broad	[brɔːd]	широкий, обширный, широко
cruel	[ˈkruːəl]	жестокий
mouse	[maʊs]	мышь
different	[ˈdɪfrənt]	другой, иной
maybe	[ˈmeɪbi]	может быть
may	[meɪ]	быть вероятным, мочь
bomb	[bɑːm]	бомба, бомбить
neck	[nek]	шея
almost	[ˈɔːlmoʊst]	почти
dark	[dɑːrk]	темный, черный, темнота
thread	[θred]	нить
beak	[biːk]	клюв
news	[nuːz]	новости
hotel	[hoʊˈtel]	отель, гостиница
turn	[tɜːrn]	поворачивать, поворачиваться, поворачивание
plant	[plænt]	растение, завод, сажать
back	[bæk]	назад, обратно, задний
perhaps	[pərˈhæps]	может быть, возможно
argue	[ˈɑːrɡjuː]	спорить, утверждать
busy	[ˈbɪzi]	занятой, занятый
world	[wɜːrld]	мир
itself	[ɪtˈself]	сам, себя
building	[ˈbɪldɪŋ]	здание
advice	[ədˈvaɪs]	совет, рекомендация
sign	[saɪn]	знак, подпись, подписывать
eat	[iːt]	есть, кушать
horse	[hɔːrs]	лошадь
but	[bət, bʌt]	но, лишь
duck	[dʌk]	утка
somewhere	[ˈsʌmwer]	где-то, куда-то
queen	[kwiːn]	королева
dictionary	[ˈdɪkʃəneri]	словарь
cut	[kʌt]	резать, разрезать, разрезание
means	[miːnz]	средство, способ
sensitive	[ˈsensətɪv]	чувствительный
moment	[ˈmoʊmənt]	момент
oil	[ɔɪl]	масло, нефть, смазать
suck	[sʌk]	сосать
competition	[ˌkɑːmpəˈtɪʃn]	соревнование, конкуренция
cool	[kuːl]	прохладный, спокойный, охлаждать(ся)
course	[kɔːrs]	курс, направление, струиться
organize	[ˈɔːrɡənaɪz]	организовывать, устраивать
holiday	[ˈhɑːlədeɪ]	праздник, отпуск
crack	[kræk]	трещина, треск, трещать
metal	[ˈmetl]	металл, металлический
honest	[ˈɑːnɪst]	честный
hello	[həˈloʊ]	привет, здравствуйте
idea	[aɪˈdiːə]	идея, мысль
fifteen	[ˌfɪfˈtiːn]	пятнадцать
art	[ɑːrt]	искусство
hear	[hɪr]	слышать
wrap	[ræp]	заворачивать, обертывать
load	[loʊd]	загружать, грузить(ся), груз
sweep	[swiːp]	мести, подметать
duty	[ˈduːti]	долг, обязанность
pattern	[ˈpætərn]	образец, шаблон
society	[səˈsaɪəti]	общество
rough	[rʌf]	грубый, шероховатый
basket	[ˈbæskɪt]	корзина
finger	[ˈfɪŋɡər]	палец
arrangement	[əˈreɪndʒmənt]	соглашение, договоренность
burst	[bɜːrst]	взрыв, взрываться
fair	[fer]	честный, справедливый
operation	[ˌɑːpəˈreɪʃn]	операция, действие
current	[ˈkɜːrənt]	текущий, действующий, течение
print	[prɪnt]	печать, отпечаток, печатать
difficult	[ˈdɪfɪkəlt]	трудный, тяжелый
offense	[əˈfens]	правонарушение, оскорбление
victory	[ˈvɪktəri]	победа
spread	[spred]	распространять(ся), простирать(ся), распространение
collect	[kəˈlekt]	собирать, коллекционировать
examine	[ɪɡˈzæmɪn]	исследовать, изучать
as	[əz, æz]	как, в качестве, как
vote	[voʊt]	голосовать, голосование
shoot	[ʃuːt]	стрелять
into	[ˈɪntə, ˈɪntu, ˈɪntuː]	в, внутрь
bus	[bʌs]	автобус
flower	[ˈflaʊər]	цветок
would	[wʊd]	выражает условное наклонение
develop	[dɪˈveləp]	развивать, разрабатывать
outside	[ˌaʊtˈsaɪd]	вне, снаружи, внешний
window	[ˈwɪndoʊ]	окно
disease	[dɪˈziːz]	болезнь, заболевание
die	[daɪ]	умирать
image	[ˈɪmɪdʒ]	изображение, образ
mineral	[ˈmɪnərəl]	минерал, руда, минеральный
obtain	[əbˈteɪn]	получать
apart	[əˈpɑːrt]	отдельно, врозь
suffer	[ˈsʌfər]	страдать
finally	[ˈfaɪnəli]	в конце концов, наконец
no	[noʊ]	нет, не, никакой
know	[noʊ]	знать
another	[əˈnʌðər]	другой, иной, другой
loyal	[ˈlɔɪəl]	лояльный, верный
sense	[sens]	чувство, ощущение, чувствовать
training	[ˈtreɪnɪŋ]	подготовка, обучение
slight	[slaɪt]	незначительный, небольшой
proposal	[prəˈpoʊzl]	предложение
gentle	[ˈdʒentl]	нежный, легкий
elect	[ɪˈlekt]	избирать, выбирать
term	[tɜːrm]	срок, термин, называть
economic	[ˌiːkəˈnɑːmɪk, ˌekə-]	экономический, экономичный
already	[ɔːlˈredi]	уже
cookie	[ˈkʊki]	печенье
singular	[ˈsɪŋɡjələr]	единственный, исключительный, единственное число
moral	[ˈmɔːrəl]	моральный, нравственный, мораль
station	[ˈsteɪʃn]	станция, пункт
pants	[pænts]	брюки, штаны
moon	[muːn]	луна
feed	[fiːd]	кормить(ся)
charge	[tʃɑːrdʒ]	плата, ответственность, обвинять
benefit	[ˈbenɪfɪt]	польза, выгода, извлекать пользу
network	[ˈnetwɜːrk]	сеть
remind	[rɪˈmaɪnd]	напоминать
power	[ˈpaʊər]	сила, мощь, питать энергией
rock	[rɑːk]	камень, скала
grandparent	[ˈɡrænperənt]	бабушка или дедушка
luck	[lʌk]	удача
judge	[dʒʌdʒ]	судить, судья
disappoint	[ˌdɪsəˈpɔɪnt]	разочаровывать
ago	[əˈɡoʊ]	тому назад
want	[wɔːnt, wɑːnt]	хотеть, желать
behind	[bɪˈhaɪnd]	сзади, за, сзади
town	[taʊn]	город, городок
price	[praɪs]	цена, оценивать
scientist	[ˈsaɪəntɪst]	ученый
ticket	[ˈtɪkɪt]	билет, талон
hundred	[ˈhʌndrəd]	сто, сотня
wild	[waɪld]	дикий
burn	[bɜːrn]	гореть, сжигать, ожог
attitude	[ˈætɪtuːd]	отношение, позиция
tool	[tuːl]	инструмент, орудие
beer	[bɪr]	пиво
offend	[əˈfend]	оскорблять, нарушать что-л.
taxi	[ˈtæksi]	такси
nervous	[ˈnɜːrvəs]	нервный, нервничающий
instruction	[ɪnˈstrʌkʃn]	инструкция, указание
June	[dʒuːn]	июнь
guest	[ɡest]	гость, гостить
opportunity	[ˌɑːpərˈtuːnəti]	возможность, удобный случай
proud	[praʊd]	гордый
yard	[jɑːrd]	ярд (91,44 см), двор
break	[breɪk]	ломать, перерыв
praise	[preɪz]	похвала, хвалить
cow	[kaʊ]	корова
risk	[rɪsk]	риск, рисковать
shine	[ʃaɪn]	светить(ся), сиять
pair	[per]	пара, образовывать пару
active	[ˈæktɪv]	активный
cold	[koʊld]	холодный, холод
department	[dɪˈpɑːrtmənt]	отдел, департамент
trip	[trɪp]	поездка, путешествие, спотыкаться
approval	[əˈpruːvl]	одобрение
chocolate	[ˈtʃɔːklət]	шоколад, шоколадный
universe	[ˈjuːnɪvɜːrs]	вселенная
simple	[ˈsɪmpl]	простой, несложный
spin	[spɪn]	крутить(ся), вращать(ся), кружение
double	[ˈdʌbl]	двойной, удваивать(ся)
sport	[spɔːrt]	спорт, вид спорт
completely	[kəmˈpliːtli]	совершенно, полностью
protest	[n - ˈproʊtest, v - prəˈtest]	протест, протестовать
garden	[ˈɡɑːrdn]	сад
thief	[θiːf]	вор
whose	[huːz]	чей, чьё
lie	[laɪ]	лежать, лгать, ложь
hit	[hɪt]	ударять, поражать, удар
cause	[kɔːz]	причина, основание, вызывать
consider	[kənˈsɪdər]	рассматривать, обдумывать
form	[fɔːrm]	форма, вид, формировать
establish	[ɪˈstæblɪʃ]	учреждать, устанавливать
determine	[dɪˈtɜːrmɪn]	определять, устанавливать
rude	[ruːd]	грубый, невежливый
prisoner	[ˈprɪznər]	заключенный
heavy	[ˈhevi]	тяжелый
if	[ɪf]	если
weapon	[ˈwepən]	оружие
with	[wɪð, wɪθ]	с, вместе с
everything	[ˈevriθɪŋ]	все
university	[ˌjuːnɪˈvɜːrsəti]	университет
quite	[kwaɪt]	вполне, совершенно
structure	[ˈstrʌktʃər]	структура, строение, структурировать
whenever	[wenˈevər]	когда бы ни, всякий раз когда
full	[fʊl]	полный, целый
damage	[ˈdæmɪdʒ]	повреждение, ущерб, повреждать
relationship	[rɪˈleɪʃnʃɪp]	взаимоотношение, отношение
desire	[dɪˈzaɪər]	желание, желать
either	[ˈaɪðər, ˈiːðər]	или, любой из двух
funny	[ˈfʌni]	смешной, забавный
origin	[ˈɔːrɪdʒɪn]	начало, происхождение
though	[ðoʊ]	хотя, несмотря на, тем не менее
post	[poʊst]	почта, пост, вывешивать
better	[ˈbetər]	лучший, более подходящий, лучше
potato	[pəˈteɪtoʊ]	картофель
over	[ˈoʊvər]	через, за, через
ignore	[ɪɡˈnɔːr]	игнорировать
trade	[treɪd]	торговля, торговать
issue	[ˈɪʃuː]	проблема, пункт
yellow	[ˈjeloʊ]	желтый, желтый цвет
infection	[ɪnˈfekʃn]	инфекция, заражение
poison	[ˈpɔɪzn]	яд, отравлять
friendly	[ˈfrendli]	дружелюбный, дружественный
earth	[ɜːrθ]	земля
corner	[ˈkɔːrnər]	угол, загонять в угол
easy	[ˈiːzi]	легкий, нетрудный, легко
show	[ʃoʊ]	показывать, шоу
kid	[kɪd]	ребенок, дурачить
salary	[ˈsæləri]	зарплата, оклад
uncle	[ˈʌŋkl]	дядя
relate	[rɪˈleɪt]	соотносить(ся), иметь отношение
choice	[tʃɔɪs]	выбор
feel	[fiːl]	чувствовать, ощущать
try	[traɪ]	пытаться, стараться, попытка
skirt	[skɜːrt]	юбка
reduction	[rɪˈdʌkʃn]	сокращение, снижение
cat	[kæt]	кошка, кот
member	[ˈmembər]	участник, член группы
further	[ˈfɜːrðər]	дальнейший, далее
grain	[ɡreɪn]	зерно
hammer	[ˈhæmər]	молот(ок)
claim	[kleɪm]	требовать, утверждать, требование
property	[ˈprɑːpərti]	собственность, имущество
owe	[oʊ]	задолжать, быть должным
walk	[wɔːk]	идти, ходить, ходьба
generous	[ˈdʒenərəs]	щедрый, великодушный
reach	[riːtʃ]	достигать, добираться, охват
study	[ˈstʌdi]	изучать, исследовать, изучение
hold	[hoʊld]	держать, удерживать
enemy	[ˈenəmi]	враг, противник
what	[wɑːt, wʌt]	что
meeting	[ˈmiːtɪŋ]	собрание, встреча
example	[ɪɡˈzæmpl]	пример
everyone	[ˈevriwʌn]	каждый, все
April	[ˈeɪprəl]	апрель
hill	[hɪl]	холм
press	[pres]	нажимать, давить, пресса
chemistry	[ˈkemɪstri]	химия
strange	[streɪndʒ]	странный, чужой, незнакомый
smoke	[smoʊk]	дым, курить
appropriate	[əˈproʊpriət]	подходящий, соответствующий
crime	[kraɪm]	преступление, преступность
reasonable	[ˈriːznəbl]	разумный
bucket	[ˈbʌkɪt]	ведро
afternoon	[ˌæftərˈnuːn]	после полудня, дневное время
major	[ˈmeɪdʒər]	основной, главный, майор
set	[set]	ставить, устанавливать, комплект
concern	[kənˈsɜːrn]	беспокойство, забота, беспокоиться
poisonous	[ˈpɔɪzənəs]	ядовитый
new	[njuː, nuː]	новый
raw	[rɔː]	сырой, необработанный
nature	[ˈneɪtʃər]	природа, сущность
port	[pɔːrt]	порт
useless	[ˈjuːsləs]	бесполезный
injury	[ˈɪndʒəri]	травма, повреждение
dust	[dʌst]	пыль, вытирать пыль
aim	[eɪm]	цель, задача, целиться
here	[hɪr]	здесь, тут
trick	[trɪk]	трюк, уловка, обманывать
talk	[tɔːk]	говорить, разговаривать, разговор
none	[nʌn]	никто, ни один
hot	[hɑːt]	горячий, жаркий, горячо
involve	[ɪnˈvɑːlv]	вовлекать, включать
fast	[fæst]	быстрый, быстро
possession	[pəˈzeʃn]	владение, собственность
real	[ˈriːəl]	реальный, подлинный, реально
choose	[tʃuːz]	выбирать
intention	[ɪnˈtenʃn]	намерение
defeat	[dɪˈfiːt]	наносить поражение, побеждать, поражение
fruit	[fruːt]	фрукт(ы)
mathematics	[ˌmæθəˈmætɪks]	математика
street	[striːt]	улица
ice	[aɪs]	лед, ледяной
mirror	[ˈmɪrər]	зеркало
disgusting	[dɪsˈɡʌstɪŋ]	отвратительный
blame	[bleɪm]	обвинять, порицать, вина
refuse	[rɪˈfjuːz]	отказывать(ся)
always	[ˈɔːlweɪz]	всегда
thin	[θɪn]	тонкий, худой, тонко
regard	[rɪˈɡɑːrd]	уважение, отношение, уважать
struggle	[ˈstrʌɡl]	делать усилия, бороться, усилие
yesterday	[ˈjestərdeɪ]	вчера, вчерашний день
electricity	[ɪˌlekˈtrɪsəti]	электричество
persuade	[pərˈsweɪd]	убеждать
cough	[kɔːf]	кашлять
draw	[drɔː]	рисовать, чертить, ничья
musician	[mjuˈzɪʃn]	музыкант
determination	[dɪˌtɜːrmɪˈneɪʃn]	решительность, решение
suddenly	[ˈsʌdənli]	вдруг, внезапно
avoid	[əˈvɔɪd]	избегать
school	[skuːl]	школа
grateful	[ˈɡreɪtfl]	благодарный, признательный
lucky	[ˈlʌki]	удачливый, удачный
evidence	[ˈevɪdəns]	доказательства, данные, свидетельствовать
cent	[sent]	цент
advantage	[ədˈvæntɪdʒ]	преимущество
centimeter	[ˈsentɪmiːtər]	сантиметр
to	[tuː, tu, tə]	пространственные значения
rope	[roʊp]	веревка, канат
funeral	[ˈfjuːnərəl]	похороны
height	[haɪt]	высота, рост
awake	[əˈweɪk]	просыпаться, будить, бодрствующий
fork	[fɔːrk]	вилка, вилы
anymore	[ˌenɪ'mɔːr]	больше не, уже не
club	[klʌb]	клуб, дубинка
western	[ˈwestərn]	западный, вестерн
Friday	[ˈfraɪdeɪ]	пятница
inch	[ɪntʃ]	дюйм, 2,54 см
collection	[kəˈlekʃn]	коллекция
priest	[priːst]	священник, жрец
knife	[naɪf]	нож
creature	[ˈkriːtʃər]	существо, создание
left	[left]	левый, левая сторона
mountain	[ˈmaʊntn]	гора
pilot	[ˈpaɪlət]	пилот, летчик, пилотировать
flow	[floʊ]	поток, течение, течь
read	[riːd]	читать, чтение
tune	[tuːn]	мелодия
live	[lɪv]	жить, живой
field	[fiːld]	поле, область, полевой
off	[ɔːf, ɑːf]	указывает на дистанцию, выключение, дальний
powerful	[ˈpaʊərfl]	мощный, сильный
usually	[ˈjuːʒuəli, ˈjuʒəli]	обычно
hall	[hɔːl]	зал, холл
advise	[ədˈvaɪz]	советовать, консультировать(ся)
year	[jɪr]	год
annoy	[əˈnɔɪ]	раздражать
complicated	[ˈkɑːmplɪkeɪtɪd]	сложный, запутанный
fight	[faɪt]	драться, сражаться, бой
shade	[ʃeɪd]	тень, оттенок, затенять
somehow	[ˈsʌmhaʊ]	как-то, так или иначе
treatment	[ˈtriːtmənt]	лечение, обработка
agency	[ˈeɪdʒənsi]	агентство
hang	[hæŋ]	вешать, висеть
represent	[ˌreprɪˈzent]	представлять, изображать
stretch	[stretʃ]	тянуть(ся), растягивать(ся)
fall	[fɔːl]	падать, падение
lose	[luːz]	терять, утрачивать
match	[mætʃ]	соответствовать, совпадать, матч, спичка
black	[blæk]	черный, черный цвет
seed	[siːd]	семя, семечко
three	[θriː]	три
decrease	[ˈdiːkriːs]	снижать(ся), уменьшать(ся), снижение
few	[fjuː]	немного, несколько, незначительное число
phone	[foʊn]	телефон, звонить по телефону
against	[əˈɡenst, əˈɡeɪnst]	против, перед
noise	[nɔɪz]	шум
army	[ˈɑːrmi]	армия, войска
separate	[j - ˈseprət, v - ˈsepəreɪt]	отдельный, отделять
band	[bænd]	банда, лента
shop	[ʃɑːp]	магазин, совершать покупки
soap	[soʊp]	мыло
skill	[skɪl]	умение, навык
adjective	[ˈædʒɪktɪv]	прилагательное
plain	[pleɪn]	равнина, простой
through	[θruː]	через, сквозь, насквозь
willing	[ˈwɪlɪŋ]	готовый (сделать что-л.)
apple	[ˈæpl]	яблоко
rent	[rent]	аренда, арендовать
surface	[ˈsɜːrfɪs]	поверхность
inside	[ˌɪnˈsaɪd]	внутри, в
low	[loʊ]	низкий, невысокий, низко
lend	[lend]	давать взаймы, одалживать
one	[wʌn]	один, один
clean	[kliːn]	чистый, чистить
pay	[peɪ]	платить, плата
about	[əˈbaʊt]	насчет, на тему, повсюду
report	[rɪˈpɔːrt]	доклад, сообщение, сообщать
medicine	[ˈmedɪsn]	медицина, лекарство
frequent	[ˈfriːkwənt]	частый
that	[ðæt]	тот, та, что
flat	[flæt]	плоский, ровный, квартира
feeling	[ˈfiːlɪŋ]	чувство, ощущение
build	[bɪld]	строить
source	[sɔːrs]	источник
track	[træk]	следить, отслеживать, след
gas	[ɡæs]	газ, горючее
model	[ˈmɑːdl]	модель, образец, моделировать
harm	[hɑːrm]	вред, вредить
game	[ɡeɪm]	игра, играть
useful	[ˈjuːsfl]	полезный
each	[iːtʃ]	каждый, каждый
morning	[ˈmɔːrnɪŋ]	утро
sting	[stɪŋ]	жалить, жало
command	[kəˈmænd]	команда, приказ, приказывать
dare	[der]	сметь, отваживаться, вызов
social	[ˈsoʊʃl]	общественный, социальный, собрание
length	[leŋθ]	длина
company	[ˈkʌmpəni]	компания, фирма
range	[reɪndʒ]	диапазон, спектр
meaning	[ˈmiːnɪŋ]	смысл, значение
grandmother	[ˈɡrænmʌðər]	бабушка
ourselves	[ɑːrˈselvz, ˌaʊər-]	себя, собой
receive	[rɪˈsiːv]	получать
breath	[breθ]	дыхание, вздох
mistake	[mɪˈsteɪk]	ошибка, ошибаться
legal	[ˈliːɡl]	легальный, законный
violence	[ˈvaɪələns]	насилие, жестокость
hardly	[ˈhɑːrdli]	вряд ли, едва ли
brain	[breɪn]	мозг
criminal	[ˈkrɪmɪnl]	преступный, криминальный, преступник
wonder	[ˈwʌndər]	удивляться, интересоваться, удивление
now	[naʊ]	сейчас, в настоящий момент
pepper	[ˈpepər]	перец, перчить
period	[ˈpɪriəd]	период, срок
rain	[reɪn]	дождь, идти (о дожде)
vowel	[ˈvaʊəl]	гласный звук
serious	[ˈsɪriəs]	серьезный
sexual	[ˈsekʃuəl]	сексуальный, половой
upper	[ˈʌpər]	верхний
afford	[əˈfɔːrd]	позволить себе, быть в состоянии
effort	[ˈefərt]	усилие, попытка
deep	[diːp]	глубокий, глубоко
shall	[ʃəl]	образует будущее время, просьбу/предложение
family	[ˈfæməli]	семья
birth	[bɜːrθ]	рождение, роды
production	[prəˈdʌkʃn]	производство, продукция
silk	[sɪlk]	шелк
anxious	[ˈæŋkʃəs]	тревожный, озабоченный
firm	[fɜːrm]	твердый, крепкий, фирма
despite	[dɪˈspaɪt]	несмотря на, злоба
importance	[ɪmˈpɔːrtns]	важность, значимость
wood	[wʊd]	дерево, (мн.) лес
tourist	[ˈtʊrɪst]	турист
happen	[ˈhæpən]	случаться, происходить
time	[taɪm]	время
exact	[ɪɡˈzækt]	точный
ride	[raɪd]	ездить, кататься, езда
much	[mʌtʃ]	весьма, очень
tired	[ˈtaɪərd]	уставший
money	[ˈmʌni]	деньги
patient	[ˈpeɪʃnt]	терпеливый, пациент
sour	[ˈsaʊər]	кислый
very	[ˈveri]	очень, самый
agree	[əˈɡriː]	соглашаться
immediate	[ɪˈmiːdiət]	немедленный, ближайший
nice	[naɪs]	хороший, приятный
several	[ˈsevrəl]	несколько, несколько
defend	[dɪˈfend]	защищать(ся)
food	[fuːd]	еда, пища
rich	[rɪtʃ]	богатый
answer	[ˈænsər]	ответ, отвечать
international	[ˌɪntərˈnæʃnəl]	международный, интернациональный
anyone	[ˈeniwʌn]	любой, кто-угодно
often	[ˈɔːfn, ˈɔːftən]	часто
football	[ˈfʊtbɔːl]	футбол
bush	[bʊʃ]	куст, кустарник
make	[meɪk]	делать, создавать
I	[aɪ]	я
gift	[ɡɪft]	подарок, дар, дарить
too	[tuː]	слишком, тоже
cap	[kæp]	кепка, фуражка
loaf	[loʊf]	буханка, батон
divide	[dɪˈvaɪd]	делить(ся), разделять(ся)
edge	[edʒ]	край, грань
join	[dʒɔɪn]	соединять, присоединиться
rank	[ræŋk]	ранг, звание, ранжировать
also	[ˈɔːlsoʊ]	также, тоже
sight	[saɪt]	зрение, вид
message	[ˈmesɪdʒ]	сообщение, послание, посылать сообщение
coast	[koʊst]	побережье, берег
nurse	[nɜːrs]	медсестра, сиделка
marry	[ˈmæri]	жениться, выходить замуж
cream	[kriːm]	крем, сливки, кремовый
carry	[ˈkæri]	нести, носить, переноска
wall	[wɔːl]	стена
between	[bɪˈtwiːn]	между, между
arm	[ɑːrm]	рука, вооружать
educate	[ˈedʒukeɪt]	воспитывать, обучать
little	[ˈlɪtl]	маленький, немного
information	[ˌɪnfərˈmeɪʃn]	информация
careful	[ˈkerfl]	осторожный, внимательный
asleep	[əˈsliːp]	спящий
dream	[driːm]	мечта, сон, мечтать
January	[ˈdʒænjueri]	январь
preserve	[prɪˈzɜːrv]	сохранять, хранить
ocean	[ˈoʊʃn]	океан
November	[noʊˈvembər]	ноябрь
prison	[ˈprɪzn]	тюрьма
test	[test]	тест, испытание, тестировать
nail	[neɪl]	гвоздь, ноготь, прибивать (гвоздями)
abroad	[əˈbrɔːd]	за границей, за границу
swell	[swel]	распухать, набухать
beach	[biːtʃ]	пляж
approve	[əˈpruːv]	одобрять, утверждать
hate	[heɪt]	ненавидеть, ненависть
finish	[ˈfɪnɪʃ]	заканчивать, завершать, конец
snake	[sneɪk]	змея
apartment	[əˈpɑːrtmənt]	квартира, апартаменты
hi	[haɪ]	привет
pound	[paʊnd]	фунт (453,6 г), фунт стерлингов
fairly	[ˈferli]	довольно-таки, достаточно
remark	[rɪˈmɑːrk]	замечание, высказывание, замечать
single	[ˈsɪŋɡl]	один, единственный, холостяк
herself	[hɜːrˈself]	себя, сама
pray	[preɪ]	молить(ся)
verb	[vɜːrb]	глагол
coat	[koʊt]	пальто, пиджак
control	[kənˈtroʊl]	контроль, регулирование, контролировать
combine	[kəmˈbaɪn]	сочетать(ся), объединять
attract	[əˈtrækt]	привлекать, притягивать
blood	[blʌd]	кровь
education	[ˌedʒuˈkeɪʃn]	образование, обучение
advertisement	[ˌædvərˈtaɪzmənt]	реклама, рекламное объявление
quickly	[ˈkwɪkli]	быстро
character	[ˈkærəktər]	характер, персонаж
payment	[ˈpeɪmənt]	оплата, платеж
he	[hi, hiː]	он
wire	[ˈwaɪər]	провод, проволока
courage	[ˈkɜːrɪdʒ]	храбрость, мужество
angry	[ˈæŋɡri]	сердитый, рассерженный
other	[ˈʌðər]	другой, иной, другой
sometimes	[ˈsʌmtaɪmz]	иногда, временами
absence	[ˈæbsəns]	отсутствие
shoe	[ʃuː]	ботинок, туфля
knowledge	[ˈnɑːlɪdʒ]	знание
speech	[spiːtʃ]	речь
bar	[bɑːr]	бар, брусок, преграждать
strict	[strɪkt]	строгий
skin	[skɪn]	кожа, шкура
like	[laɪk]	любить, нравиться, подобно
literature	[ˈlɪtrətʃər]	литература
airport	[ˈerpɔːrt]	аэропорт
sleep	[sliːp]	спать, сон
entertain	[ˌentərˈteɪn]	развлекать
impressive	[ɪmˈpresɪv]	впечатляющий
ground	[ɡraʊnd]	земля, грунт, заземлять
pen	[pen]	ручка
connection	[kəˈnekʃn]	связь, соединение
forty	[ˈfɔːrti]	сорок
permission	[pərˈmɪʃn]	разрешение, позволение
common	[ˈkɑːmən]	общий, простой
sale	[seɪl]	продажа, распродажа
computer	[kəmˈpjuːtər]	компьютер, компьютерный
odd	[ɑːd]	странный, нечетный
faith	[feɪθ]	вера
growth	[ɡroʊθ]	рост
end	[end]	конец, кончать
wool	[wʊl]	шерсть
east	[iːst]	восток, восточный
secret	[ˈsiːkrət]	секрет, тайна, тайный
butter	[ˈbʌtər]	масло
chance	[tʃæns]	шанс, случайность, случайный
factory	[ˈfækt(ə)ri]	завод, фабрика
passage	[ˈpæsɪdʒ]	проход, коридор
warn	[wɔːrn]	предупреждать
respect	[rɪˈspekt]	уважение, уважать
anywhere	[ˈeniwer]	где угодно, везде
smile	[smaɪl]	улыбаться, улыбка
death	[deθ]	смерть
reaction	[riˈækʃn]	реакция
wife	[waɪf]	жена
cost	[kɔːst]	стоить, цена
concert	[ˈkɑːnsərt]	концерт
keep	[kiːp]	держать, хранить
letter	[ˈletər]	письмо, буква
document	[ˈdɑːkjumənt]	документ, документировать
everybody	[ˈevribɑːdi]	всякий, каждый
tree	[triː]	дерево
enjoy	[ɪnˈdʒɔɪ]	наслаждаться, получать удовольствие
kilogram	[ˈkɪləɡræm]	килограмм
temperature	[ˈtemprətʃər]	температура
two	[tuː]	два
male	[meɪl]	мужчина, самец, мужской
opposite	[ˈɑːpəzət]	противоположный, обратный, напротив
slow	[sloʊ]	медленный, замедлять(ся)
behavior	[bɪˈheɪvjər]	поведение
prepare	[prɪˈper]	готовить, подготавливать
specific	[spəˈsɪfɪk]	конкретный, определенный
thick	[θɪk]	толстый, плотный
cheerful	[ˈtʃɪrfl]	веселый, радостный
suitable	[ˈsuːtəbl]	подходящий
chief	[tʃiːf]	главный, ведущий, начальник
thousand	[ˈθaʊznd]	тысяча, тысяча
themselves	[ðəmˈselvz]	сами, себя
mood	[muːd]	настроение
possess	[pəˈzes]	владеть, обладать
aunt	[ænt]	тетя
mess	[mes]	беспорядок, путаница, пачкать
cure	[kjʊr]	лечить, исцелять, лечение
fat	[fæt]	жир, жирный
spoon	[spuːn]	ложка
pump	[pʌmp]	насос, помпа
owner	[ˈoʊnər]	владелец
comfortable	[ˈkʌmftəbl]	удобный, комфортный
fence	[fens]	забор, ограда
pleasure	[ˈpleʒər]	удовольствие
home	[hoʊm]	дом, дома
life	[laɪf]	жизнь
medical	[ˈmedɪkl]	медицинский
unite	[juˈnaɪt]	объединять(ся)
shoulder	[ˈʃoʊldər]	плечо
dish	[dɪʃ]	блюдо
size	[saɪz]	размер
formal	[ˈfɔːrml]	формальный, официальный
pressure	[ˈpreʃər]	давление
name	[neɪm]	имя, название, называть
urgent	[ˈɜːrdʒənt]	срочный, неотложный
security	[səˈkjʊrəti]	безопасность, защита
mail	[meɪl]	почта, посылать по почте
reduce	[rɪˈduːs]	уменьшить, сокращать
truth	[truːθ]	правда, истина
curtain	[ˈkɜːrtn]	занавес(ка), штора
justice	[ˈdʒʌstɪs]	справедливость, правосудие
long	[lɔːŋ, lɑːŋ]	длинный, долго
shape	[ʃeɪp]	форма, придавать форму
lip	[lɪp]	губа
invite	[ɪnˈvaɪt]	приглашать
care	[ker]	заботиться, ухаживать, уход
might	[maɪt]	мощь, могущество
complete	[kəmˈpliːt]	завершать, заканчивать, полный
servant	[ˈsɜːrvənt]	слуга, прислуга
sweet	[swiːt]	сладкий, сладкое
capital	[ˈkæpɪtl]	столица, капитал, заглавный
please	[pliːz]	пожалуйста, радовать
continuous	[kənˈtɪnjuəs]	непрерывный, постоянный
any	[ˈeni]	сколько-нибудь, кто-нибудь
romantic	[roʊˈmæntɪk]	романтический, романтичный
twelve	[twelv]	двенадцать
memory	[ˈmeməri]	память, воспоминание
opposition	[ˌɑːpəˈzɪʃn]	оппозиция, сопротивление
autumn	[ˈɔːtəm]	осень
painful	[ˈpeɪnfl]	болезненный, мучительный
go	[ɡoʊ]	идти
stone	[stoʊn]	камень
twenty	[ˈtwenti]	двадцать
weak	[wiːk]	слабый
least	[liːst]	менее всего, минимальное количество
background	[ˈbækɡraʊnd]	фон, происхождение
wealth	[welθ]	богатство
wheel	[wiːl]	колесо
force	[fɔːrs]	сила, заставлять
card	[kɑːrd]	карта
equal	[ˈiːkwəl]	равный, одинаковый, равняться
heat	[hiːt]	тепло, жара, нагревать (ся)
partly	[ˈpɑːrtli]	частично, отчасти
political	[pəˈlɪtɪkl]	политический
parallel	[ˈpærəlel]	параллельный, параллель
both	[boʊθ]	оба, как..., так и
such	[sʌtʃ]	такой, подобный, такой
put	[pʊt]	класть, ставить
begin	[bɪˈɡɪn]	начинать
stop	[stɑːp]	остановка, прекращение, останавливаться
increase	[ɪnˈkriːs]	возрастать, увеличивать(ся), увеличение
pig	[pɪɡ]	свинья
touch	[tʌtʃ]	прикасаться, трогать, прикосновение
she	[ʃi, ʃiː]	она
quarrel	[ˈkwɑːrəl, ˈkwɔːrəl]	ссора, спор, ссориться
late	[leɪt]	поздний, поздно
warmth	[wɔːrmθ]	тепло, теплота
boy	[bɔɪ]	мальчик
shiny	[ˈʃaɪni]	солнечный, блестящий
remember	[rɪˈmembər]	помнить, вспоминать
response	[rɪˈspɑːns]	ответ, отклик
only	[ˈoʊnli]	единственный, только
early	[ˈɜːrli]	ранний, рано
breathe	[briːð]	дышать
table	[ˈteɪbl]	стол, таблица, класть на стол
good	[ɡʊd]	хороший
performance	[pərˈfɔːrməns]	исполнение, выступление
climb	[klaɪm]	взбираться, карабкаться
onto	[ˈɔːntu, ˈɑːntə]	на
neither	[ˈnaɪðər, ˈniːðər]	ни один, никто (из двух), тоже не
ear	[ɪr]	ухо
healthy	[ˈhelθi]	здоровый
success	[səkˈses]	успех
hand	[hænd]	рука
scene	[siːn]	сцена, вид
lack	[læk]	нехватка, отсутствие, нуждаться
responsible	[rɪˈspɑːnsəbl]	ответственный
protection	[prəˈtekʃn]	защита
before	[bɪˈfɔːr]	до, раньше, прежде
machine	[məˈʃiːn]	машина, машинный
February	[ˈfebrueri]	февраль
imagination	[ɪˌmædʒɪˈneɪʃn]	воображение
never	[ˈnevər]	никогда
tube	[tuːb]	труба, трубка
eight	[eɪt]	восемь, восьмерка
sound	[saʊnd]	звучать, звук
sympathetic	[ˌsɪmpəˈθetɪk]	сочувствующий, благожелательный
speed	[spiːd]	скорость, ускорять
delicate	[ˈdelɪkət]	деликатный, тонкий
right	[raɪt]	правый, правильный, право
recent	[ˈriːsnt]	недавний, последний
scissors	[ˈsɪzərz]	ножницы
cell	[sel]	клетка, ячейка
face	[feɪs]	лицо, встречаться
mine	[maɪn]	шахта, рудник
meal	[miːl]	принятие пищи, еда
plan	[plæn]	план, проект, планировать
pale	[peɪl]	бледный
lid	[lɪd]	крышка, веко
powder	[ˈpaʊdər]	порошок, пудра
myself	[maɪˈself]	сам, себя
water	[ˈwɔːtər]	вода
judgment	[ˈdʒʌdʒmənt]	суждение, заключение суда
wine	[waɪn]	вино
amuse	[əˈmjuːz]	развлекать, забавлять
century	[ˈsentʃəri]	век, столетие
head	[hed]	голова, возглавлять
chair	[tʃer]	стул, кресло, возглавлять
May	[meɪ]	май
steel	[stiːl]	сталь
and	[ənd, ænd]	и
night	[naɪt]	ночь
catch	[kætʃ]	поймать, ловить, поимка
improvement	[ɪmˈpruːvmənt]	улучшение, совершенствование
anxiety	[æŋˈzaɪəti]	тревога
pole	[poʊl]	столб, шест
package	[ˈpækɪdʒ]	пакет, сверток, упаковывать
lead	[liːd]	вести, сопровождать, лидерство
sort	[sɔːrt]	тип, вид, сортировать
favor	[ˈfeɪvər]	одолжение, благосклонность
sentence	[ˈsentəns]	предложение, приговор
away	[əˈweɪ]	далеко, вдали
sorry	[ˈsɔri, ˈsɑri]	извините, сожалеющий
style	[staɪl]	стиль
pronounce	[prəˈnaʊns]	произносить
anybody	[ˈenibʌdi]	любой, кто-нибудь
age	[eɪdʒ]	возраст, век, стареть
jump	[dʒʌmp]	прыгать, прыжок
necessary	[ˈnesəseri]	необходимый, необходимо
negative	[ˈneɡətɪv]	отрицательный, негативный
plane	[pleɪn]	самолет, плоскость, плоский
fish	[fɪʃ]	рыба, рыбачить
compare	[kəmˈper]	сравнивать
clever	[ˈklevər]	умный, способный
brown	[braʊn]	коричневый, бурый, коричневый цвет
desert	[n - ˈdezərt, v - dɪˈzɜːrt]	пустыня, пустынный
former	[ˈfɔːrmər]	бывший, предшествующий
related	[rɪˈleɪtɪd]	связанные
entire	[ɪnˈtaɪər]	весь, целый
demand	[dɪˈmænd]	требование, спрос, требовать
rice	[raɪs]	рис
violent	[ˈvaɪələnt]	жестокий, насильственный
word	[wɜːrd]	слово
bicycle	[ˈbaɪsɪkl]	велосипед
request	[rɪˈkwest]	просьба, запрос, просить
rest	[rest]	отдых, сон, отдыхать
use	[juːz]	использовать, употребление
center	[ˈsentər]	центр, середина чего-л., центрировать
solid	[ˈsɑːlɪd]	твердый, сплошной
mud	[mʌd]	грязь
suppose	[səˈpoʊz]	полагать, предполагать
matter	[ˈmætər]	вещество, вопрос, иметь значение
today	[təˈdeɪ]	сегодня, сегодняшний день
lonely	[ˈloʊnli]	одинокий
mean	[miːn]	иметь в виду, подразумевать, неприятный
adult	[ˈædʌlt, əˈdʌlt]	взрослый, для взрослых, взрослый
particular	[pərˈtɪkjələr]	конкретный, особый
gather	[ˈɡæðər]	собирать(ся)
solve	[sɑːlv, sɔːlv]	решать, разрешать
breast	[brest]	грудь
roll	[roʊl]	катить(ся), вращать(ся), рулон
lazy	[ˈleɪzi]	ленивый
harmful	[ˈhɑːrmfl]	вредный
balance	[ˈbæləns]	баланс, равновесие, (с)балансировать
snow	[snoʊ]	снег, идти (о снеге)
sell	[sel]	продавать
private	[ˈpraɪvət]	частный, личный
valley	[ˈvæli]	долина
ugly	[ˈʌɡli]	уродливый, безобразный
order	[ˈɔːrdər]	порядок, приказ, приказывать
original	[əˈrɪdʒənl]	оригинальный, первоначальный , оригинал
crash	[kræʃ]	крах, крушение, разбивать(ся)
bath	[bæθ]	ванна, купать
nine	[naɪn]	девять, девятка
student	[ˈstuːdnt]	студент
bottle	[ˈbɑːtl]	бутылка
criticize	[ˈkrɪtɪsaɪz]	критиковать
lung	[lʌŋ]	легкое
down	[daʊn]	вниз
December	[dɪˈsembər]	декабрь
present	[ˈpreznt]	настоящее время, текущий момент, настоящий
iron	[ˈaɪərn]	железо, утюг, железный
rob	[rɑːb]	грабить
fail	[feɪl]	терпеть неудачу, подводить, неудача
container	[kənˈteɪnər]	контейнер, сосуд
coffee	[ˈkɑfi]	кофе
convenient	[kənˈviːniənt]	удобный, подходящий
advanced	[ədˈvænst]	передовой, продвинутый
cheek	[tʃiːk]	щека, нахальство
king	[kɪŋ]	король
pile	[paɪl]	куча, груда, складывать
day	[deɪ]	день, сутки
actor	[ˈæktər]	актер
store	[stɔːr]	хранить, накапливать, магазин
horn	[hɔːrn]	рог
same	[seɪm]	тот (же) самый, такой же, то же
summer	[ˈsʌmər]	лето
dry	[draɪ]	сухой, сушить(ся)
cake	[keɪk]	торт, пирожное
reflect	[rɪˈflekt]	отражать, размышлять
move	[muːv]	передвигать, двигаться, движение
seventy	[ˈsevnti]	семьдесят, 70
else	[els]	еще, кроме
stomach	[ˈstʌmək]	живот, желудок
friend	[frend]	друг
eleven	[ɪˈlevn]	одиннадцать
liter	[ˈliːtər]	литр
punishment	[ˈpʌnɪʃmənt]	наказание
wide	[waɪd]	широкий, широко
income	[ˈɪnkʌm]	доход, прибыль
central	[ˈsentrəl]	центральный, главный
threat	[θret]	угроза
admire	[ədˈmaɪər]	восхищаться, любоваться
hope	[hoʊp]	надеяться, надежда
sudden	[ˈsʌdn]	внезапный
especially	[ɪˈspeʃəli]	особенно, в особенности
occasion	[əˈkeɪʒn]	случай, повод
raise	[reɪz]	повышать, поднимать, увеличение
factor	[ˈfæktər]	фактор
forward	[ˈfɔːrwərd]	вперед, дальше, передний
tight	[taɪt]	тугой, тесный
stage	[steɪdʒ]	этап, стадия
offensive	[əˈfensɪv]	оскорбительный, наступательный
frightening	[ˈfraɪtnɪŋ]	пугающий
recommend	[ˌrekəˈmend]	рекомендовать
wash	[wɑːʃ, wɔːʃ]	мыть(ся)
hurry	[ˈhɜːri]	спешка, торопить(ся)
Monday	[ˈmʌnd(e)ɪ]	понедельник
perfect	[ˈpɜːrfɪkt]	идеальный, совершенный
road	[roʊd]	дорога, путь
glass	[ɡlæs]	стекло, стакан, стеклянный
quantity	[ˈkwɑːntəti]	количество
come	[kʌm]	приходить, прибывать
settle	[ˈsetl]	урегулировать, улаживать
exactly	[ɪɡˈzæktli]	точно, именно
government	[ˈɡʌvərnmənt]	государство, правительство
clothing	[ˈkloʊðɪŋ]	одежда
achieve	[əˈtʃiːv]	достигать, добиваться
ability	[əˈbɪləti]	способность, умение
pot	[pɑːt]	горшок, кастрюля
explain	[ɪkˈspleɪn]	объяснять, разъяснять
prize	[praɪz]	приз
many	[ˈmeni]	многие, много, масса
strength	[streŋθ]	сила
nest	[nest]	гнездо, гнездиться
so	[soʊ]	так, настолько, так что
wet	[wet]	мокрый, влажный
emotion	[ɪˈmoʊʃn]	эмоция, волнение
out	[aʊt]	вне, снаружи, из
office	[ˈɔːfɪs, ˈɑːfɪs]	офис, служба
ancient	[ˈeɪnʃənt]	античный, древний
dirt	[dɜːrt]	грязь
cross	[krɔːs]	пересекать(ся), крест
gain	[ɡeɪn]	получать, приобретать, прирост
sure	[ʃʊr]	конечно, уверенный
serve	[sɜːrv]	служить, обслуживать
upset	[ʌpˈset]	огорчать, расстраивать, расстроенный
second	[ˈsekənd]	секунда, второй по счёту, второй
photograph	[ˈfoʊtəɡræf]	фотографировать, фотография
chest	[tʃest]	грудная клетка, сундук
nonsense	[ˈnɑːns(e)ns]	ерунда, вздор
list	[lɪst]	список, перечень, перечислять
own	[oʊn]	свой, собственный, владеть
mind	[maɪnd]	разум, ум, иметь в виду
discovery	[dɪˈskʌvəri]	открытие
pin	[pɪn]	булавка, приколоть
free	[friː]	свободный, бесплатный, свободно
operate	[ˈɑːpəreɪt]	работать, действовать
the	[ðiː, ði, ðə]	определенный артикль
acid	[ˈæsɪd]	кислота, кислотный
guess	[ɡes]	гадать, догадываться, предположение
improve	[ɪmˈpruːv]	улучшать(ся), совершенствовать(ся)
correct	[kəˈrekt]	правильный, верный, исправлять
teach	[tiːtʃ]	учить, обучать
crowd	[kraʊd]	толпа, множество, толпиться
economy	[ɪˈkɑːnəmi]	экономика, экономичность, экономичный
addition	[əˈdɪʃn]	дополнение
bunch	[bʌntʃ]	связка, гроздь
train	[treɪn]	поезд, тренировать(ся)
swim	[swɪm]	плавать, плыть, плавание
class	[klæs]	класс
prayer	[prer]	молитва, мольба
stay	[steɪ]	останавливаться, оставаться, пребывание
fine	[faɪn]	прекрасно, хорошо, прекрасный
beneath	[bɪˈniːθ]	под, внизу
last	[læst]	последний, продолжаться
ceiling	[ˈsiːlɪŋ]	потолок
thank	[θæŋk]	благодарить
across	[əˈkrɔːs, əˈkrɑːs]	поперек, через, поперек
cloth	[klɔːθ]	ткань, скатерть
defence	[dɪˈfens]	защита
attack	[əˈtæk]	атаковать, нападать, атака
exercise	[ˈeksərsaɪz]	упражнение, осуществлять
painting	[ˈpeɪntɪŋ]	картина, живопись
fashion	[ˈfæʃn]	мода
area	[ˈeriə]	пространство, область
appear	[əˈpɪr]	показываться, появляться
by	[baɪ]	у, возле, около, к, не позже чем
mouth	[maʊθ]	рот
leaf	[liːf]	лист
direct	[dəˈrekt (dɪ- / daɪ-)]	прямой, направлять
handle	[ˈhændl]	ручка, рукоять, обращаться
or	[ɔːr]	или
practical	[ˈpræktɪkl]	практичный, практический
trap	[træp]	ловушка, ловить в ловушку
possibly	[ˈpɑːsəbli]	возможно, может быть
ruler	[ˈruːlər]	правитель, линейка
fourteen	[ˌfɔːrˈtiːn]	четырнадцать
professional	[prəˈfeʃənl]	профессиональный, профессионал
why	[waɪ]	почему
explanation	[ˌekspləˈneɪʃn]	объяснение, разъяснение
position	[pəˈzɪʃn]	положение, позиция
which	[wɪtʃ]	который
decision	[dɪˈsɪʒn]	решение, определение
open	[ˈoʊpən]	открытый, открывать
religion	[rɪˈlɪdʒən]	религия
tend	[tend]	иметь тенденцию, тяготеть
chicken	[ˈtʃɪkɪn]	курица
condition	[kənˈdɪʃn]	состояние, положение, обусловливать
camera	[ˈkæmərə]	фотоаппарат, камера
continue	[kənˈtɪnjuː]	продолжать
type	[taɪp]	тип, вид, печатать
global	[ˈɡloʊbl]	глобальный
mark	[mɑːrk]	знак, отметка, помечать
box	[bɑːks]	коробка, ящик, боксировать (бить кулаком)
borrow	[ˈbɔːroʊ]	брать в долг
thought	[θɔːt]	мысль
nation	[ˈneɪʃn]	народ, нация
pocket	[ˈpɑːkɪt]	карман
cigarette	[ˈsɪɡəret]	сигарета
it	[ɪt]	это
sick	[sɪk]	больной
whom	[huːm]	кого
string	[strɪŋ]	струна, веревка
clock	[klɑːk]	часы
future	[ˈfjuːtʃər]	будущее, будущий
principle	[ˈprɪnsəpl]	принцип
direction	[dɪˈrekʃn, daɪˈrekʃn]	направление, руководство
series	[ˈsɪriːz]	ряд, последовательность
expert	[ˈekspɜːrt]	эксперт, специалист, экспертный
flag	[flæɡ]	флаг
kind	[kaɪnd]	добрый, любезный, сорт
standard	[ˈstændərd]	стандартный, обычный, стандарт
grade	[ɡreɪd]	класс, оценка, сортировать
pack	[pæk]	упаковывать, собирать, упаковка
dig	[dɪɡ]	копать, рыть
together	[təˈɡeðər]	вместе
everywhere	[ˈevriwer]	везде, всюду
mention	[ˈmenʃn]	упоминать, упоминание
television	[ˈtelɪvɪʒn]	телевидение, телевизор
of	[əv, ʌv]	указывает на отношение принадлежности
equipment	[ɪˈkwɪpmənt]	оборудование, снаряжение
well	[wel]	хорошо, вполне, хороший
chemical	[ˈkemɪkl]	химический, химический продукт
son	[sʌn]	сын
perform	[pərˈfɔːrm]	исполнять, выполнять
alcohol	[ˈælkəhɑːl]	алкоголь
swing	[swɪŋ]	качать(ся), размахивать, качание, взмах
degree	[dɪˈɡriː]	степень, градус
run	[rʌn]	бежать, бегать, бег
include	[ɪnˈkluːd]	включать в себя
yet	[jet]	еще, все еще, тем не менее
joke	[dʒoʊk]	шутка, шутить
forever	[fərˈevər]	(на)всегда, (на)вечно
welcome	[ˈwelkəm]	добро пожаловать, приветствовать
toe	[toʊ]	палец ноги, носок
beautiful	[ˈbjuːtɪfl]	красивый, прекрасный
activity	[ækˈtɪvəti]	деятельность, активность
feather	[ˈfeðər]	перо
due	[duː]	(+ to) обусловленный, должный
in	[ɪn]	в, внутри, внутри
uniform	[ˈjuːnɪfɔːrm]	униформа, равномерный
association	[əˌsoʊsiˈeɪʃn]	ассоциация, объединение
bright	[braɪt]	яркий, блестящий, ярко
remove	[rɪˈmuːv]	удалять, убирать
generally	[ˈdʒenrəli]	обычно, как правило
button	[ˈbʌtn]	кнопка, пуговица
basic	[ˈbeɪsɪk]	базовый, основной
ask	[æsk]	спрашивать
monkey	[ˈmʌŋki]	обезьяна
representative	[ˌreprɪˈzentətɪv]	представитель, представительный
once	[wʌns]	раз, однажды, один раз
illness	[ˈɪlnəs]	болезнь
invent	[ɪnˈvent]	изобретать, придумывать
tomorrow	[təˈmɔːroʊ]	завтра, завтрашний день
usual	[ˈjuːʒ(u)əl]	обычный
ball	[bɔːl]	мяч, шар
loud	[laʊd]	громкий, громко
worker	[ˈwɜːrkər]	рабочий
dismiss	[dɪsˈmɪs]	распускать, увольнять
rubber	[ˈrʌbər]	резина, каучук, резиновый
cry	[kraɪ]	плакать, кричать, плач
celebrate	[ˈselɪbreɪt]	праздновать
shock	[ʃɑːk]	удар, шок, шокировать
earn	[ɜːrn]	зарабатывать
tower	[ˈtaʊər]	башня
meter	[ˈmiːtər]	метр
explode	[ɪkˈsploʊd]	взрывать(ся)
cloud	[klaʊd]	облако, туча
envelope	[ˈenvəloʊp (ˈɑː-)]	конверт
solution	[səˈluːʃn]	решение
event	[ɪˈvent]	событие, происшествие
orange	[ˈɔːrɪndʒ]	апельсин, оранжевый цвет, оранжевый
individual	[ˌɪndɪˈvɪdʒuəl]	индивидуальный, отдельный, индивид
bean	[biːn]	боб, фасоль
minute	[ˈmɪnɪt]	минута
tonight	[təˈnaɪt]	сегодня вечером, сегодня ночью, сегодняшний вечер
worry	[ˈwɜːri]	беспокоиться, волноваться, беспокойство
grand	[ɡrænd]	великий, большой
discuss	[dɪˈskʌs]	обсуждать
gram	[ɡræm]	грамм
chin	[tʃɪn]	подбородок
March	[mɑːrtʃ]	март
true	[truː]	истинный, верный, правдиво
top	[tɑːp]	верхний, вершина
blade	[bleɪd]	лезвие, клинок
exciting	[ɪkˈsaɪtɪŋ]	захватывающий, волнующий
mix	[mɪks]	смешивать(ся), сочетать(ся), смесь
arrive	[əˈraɪv]	прибывать, приезжать
camp	[kæmp]	лагерь, располагаться лагерем
deserve	[dɪˈzɜːrv]	заслуживать, быть достойным
alive	[əˈlaɪv]	живой
follow	[ˈfɑːloʊ]	следовать, идти за
bird	[bɜːrd]	птица
forget	[fərˈɡet]	забывать
partner	[ˈpɑːrtnər]	партнер
island	[ˈaɪlənd]	остров
find	[faɪnd]	находить, встречать
goodbye	[ˌɡʊdˈbaɪ]	до свидания!
north	[nɔːrθ]	север, северный
bad	[bæd]	плохой, несчастье
freedom	[ˈfriːdəm]	свобода
whatever	[wətˈevər]	что бы ни, все что, любой
narrow	[ˈnæroʊ]	узкий
treat	[triːt]	относиться, обращаться
design	[dɪˈzaɪn]	дизайн, замысел, проектировать
needle	[ˈniːdl]	игла, иголка
rid	[rɪd]	(+ of) освобождать, избавлять
artist	[ˈɑːrtɪst]	художник, артист
normal	[ˈnɔːrml]	нормальный, обычный
sex	[seks]	секс, пол
they	[ðeɪ]	они
immediately	[ɪˈmiːdiətli]	немедленно
team	[tiːm]	команда, объединяться в команду
drug	[drʌɡ]	лекарство, наркотик, давать наркотики
teacher	[ˈtiːtʃər]	учитель
expression	[ɪkˈspreʃn]	выражение
wind	[wɪnd]	ветер
animal	[ˈænɪml]	животное, животный
milk	[mɪlk]	молоко
half	[hæf]	половина, наполовину
movie	[ˈmuːvi]	кино, фильм
people	[ˈpiːpl]	люди
sharp	[ʃɑːrp]	острый, резкий, резко
amount	[əˈmaʊnt]	количество, сумма, составлять
beard	[bɪrd]	борода
yourself	[jɔːrˈself, jərˈself]	себя, себе
service	[ˈsɜːrvɪs]	обслуживание, сервис
some	[səm, sʌm]	некоторое количество, некоторые
system	[ˈsɪstəm]	система, устройство
previous	[ˈpriːviəs]	предыдущий
relative	[ˈrelətɪv]	родственник, относительный
tell	[tel]	говорить, рассказывать
possible	[ˈpɑːsəbl]	возможный, вероятный
number	[ˈnʌmbər]	число, нумеровать
color	[ˈkʌlər]	цвет, цветной
limit	[ˈlɪmɪt]	ограничивать, предел
young	[jʌŋ]	юный, молодой, молодёжь
million	[ˈmɪljən]	миллион
seventeen	[ˌsevnˈtiːn]	семнадцать
title	[ˈtaɪtl]	название, заглавие
delay	[dɪˈleɪ]	медлить, задерживать, задержка
confidence	[ˈkɑːnfɪdəns]	уверенность, доверие
measure	[ˈmeʒər]	измерять, оценивать, мера
great	[ɡreɪt]	огромный, большой
wake	[weɪk]	проснуться, будить
next	[nekst]	следующий, затем
thorough	[ˈθɜːroʊ]	тщательный, полный
signal	[ˈsɪɡnəl]	сигнал, сигнализировать
personal	[ˈpɜːrsənl]	личный, персональный
national	[ˈnæʃnəl]	национальный, гражданин
amusing	[əˈmjuːzɪŋ]	забавный, занимательный
nobody	[ˈnoʊbədi]	никто
story	[ˈstɔːri]	рассказ, история
spring	[sprɪŋ]	весна, пружина, пружинить
quick	[kwɪk]	быстрый, быстро
citizen	[ˈsɪtɪzn]	гражданин
remain	[rɪˈmeɪn]	оставаться в каком-л. состоянии
extreme	[ɪkˈstriːm]	крайний, экстремальный
for	[fər, fɔːr]	для, за, ибо
according	[əˈkɔːrdɪŋ]	(to) согласно, в соответствии с
more	[mɔːr]	еще, больше
brave	[breɪv]	храбрый, смелый
feature	[ˈfiːtʃər]	особенность, черта, показывать
stranger	[ˈstreɪndʒər]	незнакомец, посторонний
bone	[boʊn]	кость
really	[ˈriːəli]	действительно, в самом деле
attractive	[əˈtræktɪv]	привлекательный
holy	[ˈhoʊli]	священный, святой
human	[ˈhjuːmən]	человек, человеческий
hunt	[hʌnt]	охотиться, охота
you	[juː, jə]	ты, вы
nose	[noʊz]	нос
instead	[ɪnˈsted]	вместо, взамен
part	[pɑːrt]	часть, доля
music	[ˈmjuːzɪk]	музыка
silence	[ˈsaɪləns]	тишина, молчание
gradual	[ˈɡrædʒuəl]	постепенный
communication	[kəˌmjuːnɪˈkeɪʃn]	коммуникация, информация
sheep	[ʃiːp]	овца, баран
silent	[ˈsaɪlənt]	тихий, бесшумный
take	[teɪk]	брать, взять, получать
be	[bi, biː]	быть, существовать
tennis	[ˈtenɪs]	теннис
car	[kɑːr]	автомобиль, машина
flight	[flaɪt]	полет, рейс
Sunday	[ˈsʌnd(e)ɪ]	воскресенье
taste	[teɪst]	вкус, иметь вкус
ill	[ɪl]	больной
tall	[tɔːl]	высокий
where	[wer]	где, где
passenger	[ˈpæsɪndʒər]	пассажир
grass	[ɡræs]	трава
sea	[siː]	море, морской
park	[pɑrk]	парк, парковать(ся)
inform	[ɪnˈfɔːrm]	сообщить, информировать
scientific	[ˌsaɪənˈtɪfɪk]	научный
wise	[waɪz]	мудрый
wedding	[ˈwedɪŋ]	свадьба
tropical	[ˈtrɑːpɪkl]	тропический
lock	[lɑːk]	запирать, замок
except	[ɪkˈsept]	кроме, за исключением того, что
comb	[koʊm]	гребень, расческа, расчесывать
tax	[tæks]	налог, пошлина, облагать налогом
repair	[rɪˈper]	ремонтировать, чинить, ремонт
tradition	[trəˈdɪʃn]	традиция
parent	[ˈperənt]	родитель, предок
spirit	[ˈspɪrɪt]	дух
see	[siː]	видеть, смотреть
excellent	[ˈeksələnt]	отличный
glad	[ɡlæd]	довольный
manager	[ˈmænɪdʒər]	менеджер, управляющий
August	[ˈɔːɡəst]	август
ashamed	[əˈʃeɪmd]	пристыженный
copy	[ˈkɑpi]	копировать, копия
relax	[rɪˈlæks]	расслаблять(ся)
arrival	[əˈraɪvl]	прибытие
five	[faɪv]	пять
destroy	[dɪˈstrɔɪ]	уничтожать, разрушать
independent	[ˌɪndɪˈpendənt]	независимый, самостоятельный
crop	[krɑːp]	с.-х. культура, урожай
kiss	[kɪs]	поцелуй, целовать
outer	[ˈaʊtər]	внешний, наружный
region	[ˈriːdʒən]	регион, область
spend	[spend]	тратить, расходовать
evil	[ˈiːv(ɪ)l]	зло, злой
help	[help]	помощь, помогать
wrong	[rɔːŋ]	неправильный, ошибочный, неправильно
bear	[ber]	носить, переносить, медведь
grow	[ɡroʊ]	расти, произрастать
until	[ənˈtɪl]	до, до тех пор пока
natural	[ˈnætʃrəl]	естественный, натуральный
week	[wiːk]	неделя
trial	[ˈtraɪəl]	суд, судебное разбирательство, пробный
lesson	[ˈlesn]	урок
magazine	[ˈmæɡəziːn]	журнал
variety	[vəˈraɪəti]	разнообразие
close	[kloʊz]	закрывать, закрываться, близко
plenty	[ˈplenti]	достаточно, много, множество
broadcast	[ˈbrɔːdkæst]	трансляция (радио, теле), вещание, вещать
fill	[fɪl]	заполнять, наполнять
energy	[ˈenərdʒi]	энергия
surprise	[sərˈpraɪz]	сюрприз, удивление, удивлять
newspaper	[ˈnuːzpeɪpər]	газета
effect	[ɪˈfekt]	эффект, результат, осуществлять
religious	[rɪˈlɪdʒəs]	религиозный, верующий
job	[dʒɑːb]	работа
language	[ˈlæŋɡwɪdʒ]	язык
child	[tʃaɪld]	ребенок
front	[frʌnt]	передний, перед
sixteen	[ˌsɪksˈtiːn]	шестнадцать
beside	[bɪˈsaɪd]	рядом с, около
hurt	[hɜːrt]	болеть, повредить, боль
restrict	[rɪˈstrɪkt]	ограничивать
prove	[pruːv]	доказывать
offer	[ˈɑːfər, ˈɔːfər]	предлагать, предложение
roof	[ruːf]	крыша
warm	[wɔːrm]	теплый, греть(ся)
pull	[pʊl]	тянуть
per	[pər]	из расчета на, в
September	[sepˈtembər]	сентябрь
all	[ɔːl]	все, все
clerk	[klɜrk]	клерк, офисный служащий
twice	[twaɪs]	дважды
push	[pʊʃ]	толкать, жать, толчок
line	[laɪn]	линия, черта
case	[keɪs]	случай, обстоятельство
clay	[kleɪ]	глина
candy	[ˈkændi]	конфета, леденец
affair	[əˈfer]	дело, роман
stick	[stɪk]	приклеивать(ся), липнуть, палка
toilet	[ˈtɔɪlət]	туалет
eighty	[ˈeɪti]	восемьдесят
even	[ˈiːvn]	даже, плоский
slip	[slɪp]	скользить, проскальзывать
battle	[ˈbætl]	битва, сражение, сражаться
doctor	[ˈdɑːktər]	врач, доктор, лечить
rather	[ˈræðər]	скорее, лучше
contract	[n - ˈkɑːntrækt, v - kənˈtrækt]	контракт, договор, сокращать(ся)
permanent	[ˈpɜːrmənənt]	постоянный, перманентный
block	[blɑːk]	блокировать, блок
instrument	[ˈɪnstrəmənt]	инструмент
health	[helθ]	здоровье
under	[ˈʌndər]	под
beyond	[bɪˈjɑːnd]	за, вне, за пределами
navy	[ˈneɪvi]	военно-морской флот
boil	[bɔɪl]	кипятить(ся), кипение
soon	[suːn]	скоро, вскоре
third	[θɜːrd]	третий, треть
subject	[ˈsʌbdʒɪkt, -ekt]	тема, предмет
sit	[sɪt]	сидеть
article	[ˈɑːrtɪkl]	статья, вещь
slide	[slaɪd]	скользить
blind	[blaɪnd]	слепой
multiply	[ˈmʌltɪplaɪ]	умножать(ся), увеличивать(ся)
get	[ɡet]	получить
opponent	[əˈpoʊnənt]	оппонент, противник
financial	[faɪˈnænʃl, fə-]	финансовый
ninety	[ˈnaɪnti]	девяносто
mental	[ˈmentl]	психический, умственный
loss	[lɔːs, lɑːs]	потеря, утрата
valuable	[ˈvæljuəbl]	ценный
star	[stɑːr]	звезда, звездный
dirty	[ˈdɜːrti]	грязный
layer	[ˈleɪr]	слой, класть слоями
polite	[pəˈlaɪt]	вежливый
wooden	[ˈwʊdn]	деревянный
coin	[kɔɪn]	монета
injure	[ˈɪndʒər]	ранить, повредить
around	[əˈraʊnd]	вокруг, около, вокруг
special	[ˈspeʃl]	специальный, особый
consist	[kənˈsɪst]	состоять (из), заключаться в
foreign	[ˈfɔːrən, ˈfɑːrən]	иностранный, зарубежный
fresh	[freʃ]	свежий
nerve	[nɜːrv]	нерв
ordinary	[ˈɔrdneri]	обычный, обыкновенный
address	[əˈdres, ˈædres]	адрес, обращаться
web	[web]	сеть, паутина
group	[ɡruːp]	группа, группировать
shell	[ʃel]	раковина, скорлупа
gate	[ɡeɪt]	ворота, калитка
various	[ˈveriəs, ˈvæ-]	различный
pronunciation	[prəˌnʌnsiˈeɪʃn]	произношение
among	[əˈmʌŋ]	между, среди
reason	[ˈriːzn]	причина, повод, рассуждать
empty	[ˈempti]	пустой
magic	[ˈmædʒɪk]	магия, волшебство
strategy	[ˈstrætədʒi]	стратегия
leg	[leɡ]	нога
shame	[ʃeɪm]	позор, стыд, позорить
failure	[ˈfeɪljər]	провал, неудача
work	[wɜːrk]	работа, работать
float	[floʊt]	плыть на поверхности, всплывать
above	[əˈbʌv]	вверху, наверх, над
decide	[dɪˈsaɪd]	решать, принимать решение
official	[əˈfɪʃl]	официальный, служебный, должностное лицо
intelligent	[ɪnˈtelɪdʒənt]	интеллектуальный, умный
dress	[dres]	платье, одежда, одевать(ся)
god	[ɡɑːd]	Бог, божество
govern	[ˈɡʌvərn]	управлять, править
bring	[brɪŋ]	приносить, приводить
phrase	[freɪz]	фраза, выражение
lake	[leɪk]	озеро
average	[ˈævərɪdʒ]	средний, обыкновенный, среднее
pity	[ˈpɪti]	жалость
again	[əˈɡen, əˈɡeɪn]	опять, ещё
dull	[dʌl]	тупой, глупый
nearly	[ˈnɪrli]	близко, около
rare	[rer]	редкий
ready	[ˈredi]	готовый
how	[haʊ]	как
therefore	[ˈðerfɔːr]	поэтому, следовательно
share	[ʃer]	делить, разделять, доля
way	[weɪ]	путь, направление
process	[ˈproʊses]	процесс, подвергать процессу
heel	[hiːl]	пятка, каблук
weather	[ˈweðər]	погода
pink	[pɪŋk]	розовый, розовый цвет
react	[riˈækt]	реагировать
conscience	[ˈkɑːnʃəns]	совесть
minister	[ˈmɪnɪstər]	министр
stand	[stænd]	стоять, стойка
page	[peɪdʒ]	страница
pipe	[paɪp]	труба, трубка
below	[bɪˈloʊ]	ниже, ниже
girl	[ɡɜːrl]	девочка
path	[pæθ]	путь, дорожка
detail	[ˈdiːteɪl]	деталь, подробность, детализировать
sincere	[sɪnˈsɪr]	искренний
boat	[boʊt]	лодка
meet	[miːt]	встречать, встречаться
value	[ˈvæljuː]	ценность, значение, ценить
history	[ˈhɪstri]	история
prefer	[prɪˈfɜːr]	предпочитать
circle	[ˈsɜːrkl]	круг
travel	[ˈtrævl]	путешествовать, путешествие
fever	[ˈfiːvər]	жар, лихорадка
twist	[twɪst]	крутить, скручивать, поворот
college	[ˈkɑːlɪdʒ]	колледж, университет
shelf	[ʃelf]	полка
cheese	[tʃiːz]	сыр
daughter	[ˈdɔːtər]	дочь
electric	[ɪˈlektrɪk]	электрический
from	[frəm, frɑːm]	от, из
state	[steɪt]	состояние, государство, заявлять
mysterious	[mɪˈstɪriəs]	таинственный, загадочный
skillful	[ˈskɪlfl]	искусный, умелый
pet	[pet]	домашнее животное, ласкать
role	[roʊl]	роль
attend	[əˈtend]	посещать, присутствовать
whisper	[ˈwɪspər]	шептать(ся)
dance	[dæns]	танцевать, танец
need	[niːd]	нуждаться, необходимость
red	[red]	красный, красный цвет
court	[kɔːrt]	суд, судебное заседание
sink	[sɪŋk]	тонуть, раковина
purple	[ˈpɜːrpl]	фиолетовый, пурпурный, пурпур
belong	[bɪˈlɔːŋ]	принадлежать
should	[ʃud]	должен
culture	[ˈkʌltʃər]	культура
swear	[swer]	клясться, ругаться, клятва
waste	[weɪst]	растрачивать, тратить впустую, растрата
method	[ˈmeθəd]	прием, метод
fly	[flaɪ]	летать, муха
clear	[klɪr]	ясный, чистый, очистить
learn	[lɜːrn]	учиться, учить
huge	[hjuːdʒ]	огромный
stream	[striːm]	поток
himself	[hɪmˈself]	сам, себя
sew	[soʊ]	шить, зашивать
environment	[ɪnˈvaɪrənmənt]	окружающая среда, окружение
profession	[prəˈfeʃn]	профессия
love	[lʌv]	любовь, любить
wear	[wer]	носить
trouble	[ˈtrʌbl]	беспокойство, неприятность, беспокоить
oppose	[əˈpoʊz]	выступать против, противодействовать
tongue	[tʌŋ]	язык
customer	[ˈkʌstəmər]	клиент, покупатель
opinion	[əˈpɪnjən]	мнение
sixty	[ˈsɪksti]	шестьдесят, 60
lawyer	[ˈlɔːjər]	адвокат, юрист
rub	[rʌb]	тереть(ся)
thumb	[θʌm]	большой палец руки
adverb	[ˈædvɜːrb]	наречие
vacation	[vəˈkeɪʃn, veɪ-]	отпуск, каникулы
organ	[ˈɔrɡən]	орган
tie	[taɪ]	завязывать, связывать, галстук
drum	[drʌm]	барабан
freeze	[friːz]	замерзать, замораживать, мороз
enter	[ˈentər]	входить, вводить
spell	[spel]	произносить по буквам, писать по буквам, заклинание
eye	[aɪ]	глаз
pencil	[ˈpensl]	карандаш
church	[tʃɜːrtʃ]	церковь, церковный
confident	[ˈkɑːnfɪdənt]	уверенный
we	[wi, wiː]	мы
sky	[skaɪ]	небо
including	[ɪnˈkluːdɪŋ]	включая
ten	[ten]	десять, десятка
main	[meɪn]	главный, основной
view	[vjuː]	вид, взгляд, обозревать
steady	[ˈstedi]	устойчивый, постоянный
old	[oʊld]	старый
large	[lɑːrdʒ]	большой, крупный
root	[ruːt]	корень
steep	[stiːp]	крутой
farmer	[ˈfɑːrmər]	фермер
rate	[reɪt]	показатель чего-л., ставка, присваивать рейтинг
branch	[bræntʃ]	ветвь, ответвление
pool	[puːl]	бассейн, лужа
breakfast	[ˈbrekfəst]	завтрак
telephone	[ˈtelɪfoʊn]	телефон, звонить по телефону
interest	['ɪnt(ə)rəst]	интерес, выгода, интересовать
stiff	[stɪf]	жесткий, тугой
smart	[smɑːrt]	умный, элегантный
arrange	[əˈreɪndʒ]	организовывать, расставлять
possibility	[ˌpɑːsəˈbɪləti]	возможность, вероятность
watch	[wɑːtʃ]	смотреть, наблюдать, часы
plural	[ˈplʊrəl]	множественный, множественное число
tooth	[tuːθ]	зуб
marriage	[ˈmærɪdʒ]	брак, замужество
check	[tʃek]	проверять, проверка
start	[stɑːrt]	начало, старт, начинать
sum	[sʌm]	сумма
nut	[nʌt]	орех, чудак
available	[əˈveɪləbl]	доступный
happy	[ˈhæpi]	счастливый, довольный
reward	[rɪˈwɔːrd]	награда, вознаграждение, вознаграждать
who	[huː]	кто
high	[haɪ]	высоко, высокий
smell	[smel]	запах, обоняние, пахнуть
south	[saʊθ]	юг, южный
shirt	[ʃɜːrt]	рубашка
poor	[pʊr, pɔːr]	бедный
salt	[sɔːlt]	соль, солить
listen	[ˈlɪsn]	слушать
however	[haʊˈevər]	как бы ни, однако
indeed	[ɪnˈdiːd]	в самом деле, действительно
blow	[bloʊ]	дуть, порыв ветра
radio	[ˈreɪdioʊ]	радио
media	[ˈmiːdiə]	СМИ, масс-медиа
product	[ˈprɑːdʌkt]	продукт, продукция
knock	[nɑːk]	стучать(ся), стук
understand	[ˌʌndərˈstænd]	понимать
sugar	[ˈʃʊɡər]	сахар
obey	[əˈbeɪ]	повиноваться, слушаться
something	[ˈsʌmθɪŋ]	кое-что, нечто
father	[ˈfɑːðər]	отец
difference	[ˈdɪfrəns]	разница, отличие
discover	[dɪˈskʌvər]	открывать, обнаруживать
traditional	[trəˈdɪʃənl]	традиционный
forgive	[fərˈɡɪv]	прощать
steam	[stiːm]	пар
worse	[wɜːrs]	хуже, худший
throw	[θroʊ]	бросать, кидать, бросок
pure	[pjʊr]	чистый
shadow	[ˈʃædoʊ]	тень
piano	[piˈænoʊ]	пианино, фортепьяно
forest	[ˈfɔːrɪst, ˈfɑːrɪst]	лес, лесной
safety	[ˈseɪfti]	безопасность
actually	[ˈæktʃuəli]	на самом деле, фактически
suit	[suːt]	костюм, устраивать
somebody	[ˈsʌmbədi]	кто-то, кто-нибудь
mystery	[ˈmɪstri]	тайна, таинство
escape	[ɪˈskeɪp]	побег, бегство, бежать (из заключения)
land	[lænd]	земля, высаживаться
program	[ˈproʊɡræm]	программа, программировать
at	[ət, æt]	у, за
anger	[ˈæŋɡər]	гнев, злость
scatter	[ˈskætər]	рассеивать(ся), разбрасывать
thirty	[ˈθɜːrti]	тридцать
kill	[kɪl]	убивать
look	[lʊk]	смотреть, глядеть, взгляд
piece	[piːs]	часть, кусок
leave	[liːv]	покидать, оставлять
woman	[ˈwʊmən]	женщина
save	[seɪv]	сохранять, спасать
along	[əˈlɔːŋ]	вдоль, по, вдоль
explosion	[ɪkˈsploʊʒn]	взрыв, вспышка
month	[mʌnθ]	месяц
director	[dɪˈrektər, daɪ-]	директор, руководитель
plate	[pleɪt]	тарелка, пластинка
west	[west]	запад, западный
net	[net]	сеть
regular	[ˈreɡjələr]	регулярный
become	[bɪˈkʌm]	становиться, случаться
hide	[haɪd]	скрывать(ся)
wave	[weɪv]	волна, махать
northern	[ˈnɔːrðərn]	северный
guard	[ɡɑːrd]	охрана, охранять
quality	[ˈkwɑːləti]	качество
middle	[ˈmɪdl]	середина, средний
without	[wɪˈðaʊt]	без
split	[splɪt]	расщеплять(ся), разбивать на части, расщепление
unless	[ənˈles]	если не, пока не
organization	[ˌɔːrɡənəˈzeɪʃn]	организация
buy	[baɪ]	покупать, покупка
flame	[fleɪm]	пламя
dead	[ded]	мертвый, умерший, покойник
forbid	[fərˈbɪd]	запрещать
bottom	[ˈbɑːtəm]	низ, нижний
badly	[ˈbædli]	скверно, плохо
question	[ˈkwestʃən]	вопрос, спрашивать
believe	[bɪˈliːv]	верить
ship	[ʃɪp]	корабль, судно
hungry	[ˈhʌŋɡri]	голодный
fault	[fɔːlt]	вина, ошибка
stupid	[ˈstuːpɪd]	глупый
Thursday	[ˈθɜːrzd(e)ɪ]	четверг
worst	[wɜːrst]	наихудший, наихудшее
July	[dʒuˈlaɪ]	июль
kitchen	[ˈkɪtʃɪn]	кухня
miss	[mɪs]	скучать, упускать, пропускать, потеря
railroad	[ˈreɪlroʊd]	железная дорога
slope	[sloʊp]	склон, наклон
false	[fɔːls]	ложный
situation	[ˌsɪtʃuˈeɪʃn]	ситуация
during	[ˈdʊrɪŋ]	во время, в течение
market	[ˈmɑːrkɪt]	рынок
paper	[ˈpeɪpər]	бумага
call	[kɔːl]	вызывать, окликать, звонок
relation	[rɪˈleɪʃn]	связь, отношение
ruin	[ˈruːɪn]	разрушать, губить, руины
heart	[hɑːrt]	сердце
pass	[pæs]	проходить, сдавать, проход
place	[pleɪs]	место, помещать
library	[ˈlaɪbreri]	библиотека
Saturday	[ˈsætərd(e)ɪ]	суббота
reply	[rɪˈplaɪ]	ответ, отвечать
introduction	[ˌɪntrəˈdʌkʃn]	введение, представление кого-л.
leather	[ˈleðər]	кожа, кожаный
onion	[ˈʌnjən]	лук
previously	[ˈpriviəsli]	ранее, заранее
account	[əˈkaʊnt]	счет, расчет, отчитываться
four	[fɔːr]	четыре
mixture	[ˈmɪkstʃər]	смесь
introduce	[ˌɪntrəˈdjuːs]	представлять, вводить
dog	[dɔːɡ]	собака
OK	[oʊˈkeɪ]	хорошо, ладно, в порядке
hard	[hɑːrd]	трудный, твёрдый, жестко
glue	[ɡluː]	клей, клеить(ся)
a	[ə]	неопределенный артикль, один из
polish	[ˈpɑːlɪʃ]	полировать, наводить лоск, полировка
lamp	[læmp]	лампа
step	[step]	шаг, ступать
kick	[kɪk]	пинать, ударять ногой, пинок
border	[ˈbɔːrdər]	граница
cup	[kʌp]	чашка, чаша
belt	[belt]	ремень, пояс
guide	[ɡaɪd]	путеводитель, гид, вести
big	[bɪɡ]	большой
voice	[vɔɪs]	голос, произносить
accident	[ˈæksɪdənt]	авария, случай
bend	[bend]	сгибать(ся), поворачивать, изгиб
warning	[ˈwɔːrnɪŋ]	предупреждение
can	[kən, kæn]	мочь, уметь
preparation	[ˌprepəˈreɪʃn]	подготовка
clearly	[ˈklɪrli]	ясно, очевидно
adventure	[ədˈventʃər]	приключение
honor	[ˈɑːnər]	честь
hair	[her]	волосы
confuse	[kənˈfjuːz]	путать, сбивать с толку
distance	[ˈdɪstəns]	дистанция, расстояние
secretary	[ˈsekrəteri]	секретарь
truck	[trʌk]	грузовик
square	[skwer]	квадрат, площадь, квадратный
afraid	[əˈfreɪd]	боящийся, испуганный
conversation	[ˌkɑːnvərˈseɪʃn]	разговор, беседа
give	[ɡɪv]	дать, передать
guilty	[ˈɡɪlti]	виновный, виноватый
satisfaction	[ˌsætɪsˈfækʃn]	удовлетворение
than	[ðən]	чем, нежели
man	[mæn]	мужчина, человек
act	[ækt]	действовать, поступать, действие
fifty	[ˈfɪfti]	пятьдесят, 50
hour	[ˈaʊər]	час
grave	[ɡreɪv]	могила, серьезный
just	[dʒʌst]	точно, как раз, справедливый
writer	[ˈraɪtər]	писатель
depend	[dɪˈpend]	зависеть, рассчитывать
helpful	[ˈhelpfl]	полезный
physical	[ˈfɪzɪkl]	физический, материальный
cupboard	[ˈkʌbərd]	шкаф, буфет
admit	[ədˈmɪt]	допускать, принимать
attention	[əˈtenʃn]	внимание
sheet	[ʃiːt]	лист, простыня
airplane	[ˈerpleɪn]	самолет
round	[raʊnd]	круглый, вокруг
film	[fɪlm]	фильм, снимать фильм
city	[ˈsɪti]	город
ought	[ˈɔt]	(+ to) должен
picture	[ˈpɪktʃər]	картинка, рисунок, изобразить
win	[wɪn]	победить, выиграть, победа
English	[ˈɪŋɡlɪʃ]	английский язык, англичане, английский
brick	[brɪk]	кирпич
vegetable	[ˈvedʒtəbl]	овощ
winter	[ˈwɪntər]	зима
house	[haʊs]	дом, жилище
dollar	[ˈdɑːlər]	доллар
sock	[sɑːk]	носок
because	[bɪˈkɔːz, bɪˈkʌz]	потому что
supply	[səˈplaɪ]	поставка, снабжение, поставлять
sad	[sæd]	грустный, печальный
return	[rɪˈtɜːrn]	возвращать, возвращаться, возвращение
absent	[æbˈsent]	отсутствующий, отсутствовать
thus	[ðʌs]	таким образом, поэтому
temporary	[ˈtempəreri]	временный
must	[mʌst]	должен, обязан, необходимость
ever	[ˈevər]	всегда, вечно
problem	[ˈprɑbləm]	проблема, проблемный
bite	[baɪt]	кусать(ся), укусить, укус
recognize	[ˈrekəɡnaɪz]	распознавать, признавать
sore	[sɔːr]	больной, болезненный, больное место
politician	[ˌpɑːləˈtɪʃn]	политик
discussion	[dɪˈskʌʃn]	дискуссия, обсуждение
yes	[jes]	да, утвердительный ответ
smooth	[smuːð]	гладкий, плавный
player	[ˈpleɪər]	игрок, плеер
beat	[biːt]	бить, удар
research	[rɪˈsɜːrtʃ, ˈriːsɜːrt&]	исследование, исследовать
Tuesday	[ˈtuːzd(e)ɪ]	вторник
wing	[wɪŋ]	крыло
typical	[ˈtɪpɪkl]	типичный
elbow	[ˈelboʊ]	локоть
race	[reɪs]	гонка, заезд, участвовать в гонках
brush	[brʌʃ]	щетка, кисть, чистить (щеткой)
substance	[ˈsʌbstəns]	вещество, субстанция
wish	[wɪʃ]	желать, желание
furniture	[ˈfɜːrnɪtʃər]	мебель
think	[θɪŋk]	думать
send	[send]	посылать
soil	[sɔɪl]	почва, земля, пачкать(ся)
egg	[eɡ]	яйцо
whether	[ˈweðər]	ли, который из двух
local	[ˈloʊkl]	местный, локальный, местный (житель)
most	[moʊst]	наиболее, самый большой
require	[rɪˈkwaɪər]	требовать, нуждаться
election	[ɪˈlekʃn]	выборы